Word,Answer,Score,Occurrence,Green,Yellow,Weighted Sum
roate,FALSE,6761886,4142,1254,2888,2698
soare,FALSE,6757516,4093,1528,2565,2810.5
orate,FALSE,6753202,4142,1178,2964,2660
irate,TRUE,6722262,4116,1171,2945,2643.5
raile,FALSE,6712882,4097,1261,2836,2679
taler,FALSE,6712394,4117,1095,3022,2606
arose,TRUE,6708015,4093,1247,2846,2670
oater,FALSE,6687658,4142,986,3156,2564
stare,TRUE,6687170,4087,1326,2761,2706.5
later,TRUE,6686176,4117,1033,3084,2575
raise,TRUE,6679117,4067,1270,2797,2668.5
arise,TRUE,6678815,4067,1269,2798,2668
ariel,FALSE,6677316,4097,1148,2949,2622.5
taser,FALSE,6663932,4087,1063,3024,2575
ratel,FALSE,6658008,4117,994,3123,2555.5
artel,FALSE,6657706,4117,993,3124,2555
alter,TRUE,6651111,4117,983,3134,2550
reast,FALSE,6632447,4087,1078,3009,2582.5
strae,FALSE,6629696,4087,1193,2894,2640
tares,FALSE,6619206,4087,970,3117,2528.5
laser,FALSE,6617030,4068,1002,3066,2535
realo,FALSE,6602990,4123,874,3249,2498.5
raine,FALSE,6591660,3999,1281,2718,2640
alert,TRUE,6586656,4117,924,3193,2520.5
tears,FALSE,6576662,4087,886,3201,2486.5
lares,FALSE,6572304,4068,909,3159,2488.5
seral,FALSE,6571038,4068,1090,2978,2579
rates,FALSE,6570738,4087,874,3213,2480.5
saner,TRUE,6564605,3970,1339,2631,2654.5
snare,TRUE,6553555,3970,1336,2634,2653
rales,FALSE,6550054,4068,875,3193,2471.5
arles,FALSE,6549752,4068,874,3194,2471
slate,TRUE,6543989,3898,1437,2461,2667.5
stear,FALSE,6539949,4087,995,3092,2541
aster,FALSE,6539426,4087,798,3289,2442.5
earst,FALSE,6538415,4087,963,3124,2525
resat,FALSE,6535834,4087,843,3244,2465
terai,FALSE,6535682,4116,728,3388,2422
reals,FALSE,6531952,4068,852,3216,2460
aesir,FALSE,6530664,4067,833,3234,2450
lears,FALSE,6529760,4068,825,3243,2446.5
reais,FALSE,6529462,4067,848,3219,2457.5
teras,FALSE,6519188,4087,753,3334,2420
salet,FALSE,6511346,3898,1353,2545,2625.5
crate,TRUE,6508140,3917,1335,2582,2626
trace,TRUE,6507422,3917,1299,2618,2608
aeros,FALSE,6505958,4093,714,3379,2403.5
stale,TRUE,6504912,3898,1336,2562,2617
arets,FALSE,6503011,4087,760,3327,2423.5
serai,FALSE,6500262,4067,945,3122,2506
antre,FALSE,6496983,4019,915,3104,2467
stoae,FALSE,6492490,3923,1274,2649,2598.5
retia,FALSE,6489962,4116,680,3436,2398
laers,FALSE,6487461,4068,757,3311,2412.5
learn,TRUE,6485412,4000,919,3081,2459.5
urate,FALSE,6485322,3926,1170,2756,2548
carte,FALSE,6464918,3917,1228,2689,2572.5
caret,FALSE,6462984,3917,1236,2681,2576.5
torse,FALSE,6460993,3851,1186,2665,2518.5
carle,FALSE,6451258,3898,1251,2647,2574.5
earnt,FALSE,6450958,4019,974,3045,2496.5
least,TRUE,6447997,3898,1061,2837,2479.5
cater,TRUE,6442596,3917,1143,2774,2530
earls,FALSE,6437920,4068,737,3331,2402.5
urase,FALSE,6437897,3877,1202,2675,2539.5
store,TRUE,6434044,3851,1263,2588,2557
nares,FALSE,6432539,3970,858,3112,2414
soler,FALSE,6429992,3832,1287,2545,2559.5
slier,FALSE,6425357,3806,1363,2443,2584.5
renal,TRUE,6424937,4000,805,3195,2402.5
sorel,FALSE,6424074,3832,1282,2550,2557
oriel,FALSE,6421952,3861,1048,2813,2454.5
neral,FALSE,6419791,4000,761,3239,2380.5
tiler,FALSE,6419506,3855,993,2862,2424
saine,FALSE,6418692,3780,1542,2238,2661
carse,FALSE,6417493,3868,1260,2608,2564
tales,FALSE,6412506,3898,919,2979,2408.5
reans,FALSE,6410730,3970,872,3098,2421
trone,FALSE,6410614,3783,1266,2517,2524.5
slane,FALSE,6409107,3781,1480,2301,2630.5
stire,FALSE,6404844,3825,1285,2540,2555
aisle,TRUE,6403634,3878,1009,2869,2443.5
alone,TRUE,6401345,3836,1192,2644,2514
aloes,FALSE,6400033,3904,940,2964,2422
litre,FALSE,6398192,3855,977,2878,2416
liane,FALSE,6396648,3810,1203,2607,2506.5
scare,TRUE,6395260,3868,1289,2579,2578.5
teals,FALSE,6394404,3898,896,3002,2397
liter,FALSE,6393288,3855,931,2924,2393
alure,FALSE,6392369,3907,1083,2824,2495
nears,FALSE,6389995,3970,774,3196,2372
roset,FALSE,6388870,3851,1035,2816,2443
react,TRUE,6388672,3917,1059,2858,2488
setal,FALSE,6385022,3898,1038,2860,2468
siler,FALSE,6384086,3806,1210,2596,2508
stane,FALSE,6383690,3800,1356,2444,2578
lacer,FALSE,6383612,3898,978,2920,2438
trine,FALSE,6381414,3757,1288,2469,2522.5
tries,FALSE,6380102,3825,1036,2789,2430.5
atone,TRUE,6375928,3855,1068,2787,2461.5
oiler,FALSE,6374086,3861,885,2976,2373
crane,TRUE,6373258,3800,1378,2422,2589
tores,FALSE,6372224,3851,945,2906,2398
aline,FALSE,6372145,3810,1214,2596,2512
loser,TRUE,6370048,3832,977,2855,2404.5
trade,TRUE,6366433,3839,1216,2623,2527.5
uraei,FALSE,6365622,3906,936,2970,2421
reoil,FALSE,6363606,3861,905,2956,2383
anole,FALSE,6363535,3836,1058,2778,2447
leats,FALSE,6361162,3898,812,3086,2355
leant,TRUE,6360540,3830,1072,2758,2451
toner,FALSE,6353043,3783,1097,2686,2440
taels,FALSE,6352105,3898,828,3070,2363
reist,FALSE,6350121,3825,1037,2788,2431
toeas,FALSE,6345827,3923,804,3119,2363.5
oaten,FALSE,6343422,3855,904,2951,2379.5
trail,TRUE,6341968,3708,1037,2671,2372.5
laten,FALSE,6341940,3830,951,2879,2390.5
ursae,FALSE,6341284,3877,967,2910,2422
relit,FALSE,6341102,3855,870,2985,2362.5
sayer,FALSE,6339444,3837,1229,2608,2533
scrae,FALSE,6337786,3868,1156,2712,2512
ariot,FALSE,6336596,3733,1059,2674,2396
rayle,FALSE,6335058,3867,1024,2843,2445.5
anile,FALSE,6334335,3810,1080,2730,2445
irone,FALSE,6334254,3763,1151,2612,2457
coate,FALSE,6333856,3753,1347,2406,2550
prate,FALSE,6332466,3815,1279,2536,2547
telia,FALSE,6331730,3927,725,3202,2326
cares,FALSE,6328724,3868,1019,2849,2443.5
toile,FALSE,6328352,3691,1280,2411,2485.5
layer,TRUE,6327962,3867,951,2916,2409
steal,TRUE,6327331,3898,939,2959,2418.5
ronte,FALSE,6326897,3783,1086,2697,2434.5
alien,TRUE,6326485,3810,1056,2754,2433
tires,FALSE,6326318,3825,868,2957,2346.5
lores,FALSE,6325322,3832,884,2948,2358
rotes,FALSE,6323756,3851,849,3002,2350
trape,FALSE,6322088,3815,1197,2618,2506
roast,TRUE,6320947,3704,1115,2589,2409.5
slart,FALSE,6319073,3679,1279,2400,2479
teary,TRUE,6317722,3886,1214,2672,2550
earns,FALSE,6316698,3970,757,3213,2363.5
hater,TRUE,6311814,3848,1014,2834,2431
clear,TRUE,6310304,3898,951,2947,2424.5
share,TRUE,6310108,3799,1393,2406,2596
caner,FALSE,6309543,3800,1171,2629,2485.5
liart,FALSE,6306614,3708,1002,2706,2355
loner,FALSE,6306141,3764,1036,2728,2400
dater,FALSE,6305079,3839,1056,2783,2447.5
osier,FALSE,6303672,3831,853,2978,2342
roles,FALSE,6303072,3832,850,2982,2341
trial,TRUE,6302836,3708,1001,2707,2354.5
tolar,FALSE,6300876,3734,915,2819,2324.5
anise,FALSE,6300570,3780,1089,2691,2434.5
snore,TRUE,6300429,3734,1273,2461,2503.5
noter,FALSE,6299429,3783,957,2826,2370
tared,FALSE,6298894,3839,1052,2787,2445.5
toise,FALSE,6294587,3661,1289,2372,2475
orles,FALSE,6294388,3832,774,3058,2303
ureal,FALSE,6294081,3907,796,3111,2351.5
resit,FALSE,6292640,3825,838,2987,2331.5
paire,FALSE,6291436,3795,1288,2507,2541.5
haler,FALSE,6291130,3829,1015,2814,2422
irade,FALSE,6290073,3819,1101,2718,2460
heart,TRUE,6289658,3848,1023,2825,2435.5
thrae,FALSE,6288054,3848,1043,2805,2445.5
ayrie,FALSE,6287748,3866,909,2957,2387.5
tesla,FALSE,6285758,3898,697,3201,2297.5
prase,FALSE,6285041,3766,1311,2455,2538.5
aurei,FALSE,6283182,3906,819,3087,2362.5
rance,FALSE,6282679,3800,1124,2676,2462
rathe,FALSE,6277896,3848,972,2876,2410
rites,FALSE,6277850,3825,772,3053,2298.5
tenor,TRUE,6276833,3783,874,2909,2328.5
parle,FALSE,6275584,3796,1195,2601,2495.5
stair,TRUE,6274536,3678,1120,2558,2399
leary,FALSE,6270820,3867,1153,2714,2510
saute,TRUE,6270318,3707,1398,2309,2552.5
taper,TRUE,6270124,3815,1041,2774,2428
tinea,FALSE,6269685,3829,872,2957,2350.5
porae,FALSE,6269306,3821,1171,2650,2496
races,FALSE,6268174,3868,819,3049,2343.5
lader,FALSE,6267019,3820,997,2823,2408.5
pater,FALSE,6266922,3815,1087,2728,2451
aures,FALSE,6266688,3877,844,3033,2360.5
areic,FALSE,6266506,3897,774,3123,2335.5
solar,TRUE,6265456,3685,1132,2553,2408.5
deair,FALSE,6263803,3819,1030,2789,2424.5
sared,FALSE,6263474,3790,1269,2521,2529.5
serac,FALSE,6263413,3868,965,2903,2416.5
saice,FALSE,6262374,3678,1512,2166,2595
stela,FALSE,6261793,3898,846,3052,2372
adore,TRUE,6261412,3845,981,2864,2413
liner,TRUE,6260235,3738,959,2779,2348.5
soral,FALSE,6259538,3685,1127,2558,2406
nitre,FALSE,6258427,3757,926,2831,2341.5
riles,FALSE,6257166,3806,773,3033,2289.5
recal,FALSE,6255426,3898,722,3176,2310
niter,FALSE,6253523,3757,880,2877,2318.5
oared,FALSE,6253474,3845,944,2901,2394.5
lanes,FALSE,6253235,3781,885,2896,2333
stole,TRUE,6251786,3662,1273,2389,2467.5
rated,FALSE,6250426,3839,956,2883,2397.5
nacre,FALSE,6248751,3800,973,2827,2386.5
grate,TRUE,6247999,3769,1252,2517,2510.5
ceria,FALSE,6247948,3897,825,3072,2361
leirs,FALSE,6247434,3806,784,3022,2295
siren,TRUE,6246550,3708,1179,2529,2443.5
nates,FALSE,6246523,3800,806,2994,2303
rotal,FALSE,6246490,3734,814,2920,2274
paler,TRUE,6246238,3796,1088,2708,2442
resto,FALSE,6245568,3851,624,3227,2237.5
peart,FALSE,6244766,3815,1096,2719,2455.5
arsey,FALSE,6242350,3837,1170,2667,2503.5
parse,TRUE,6241819,3766,1204,2562,2485
tiers,FALSE,6241475,3825,716,3109,2270.5
senor,FALSE,6241413,3734,1091,2643,2412.5
spare,TRUE,6241183,3766,1310,2456,2538
sitar,FALSE,6240234,3678,1054,2624,2366
spaer,FALSE,6236279,3766,1264,2502,2515
ratio,TRUE,6234046,3733,736,2997,2234.5
rinse,TRUE,6233566,3708,1041,2667,2374.5
alder,FALSE,6231954,3820,947,2873,2383.5
taros,FALSE,6231496,3704,784,2920,2244
aider,TRUE,6230977,3819,948,2871,2383.5
noser,FALSE,6230283,3734,926,2808,2330
aeons,FALSE,6230000,3806,845,2961,2325.5
arled,FALSE,6229440,3820,956,2864,2388
ocrea,FALSE,6226984,3923,626,3297,2274.5
leans,FALSE,6226280,3781,855,2926,2318
derat,FALSE,6225449,3839,932,2907,2385.5
trice,TRUE,6225096,3655,1258,2397,2456.5
orant,FALSE,6224806,3636,1050,2586,2343
pareo,FALSE,6224088,3821,985,2836,2403
stile,FALSE,6222586,3636,1295,2341,2465.5
neats,FALSE,6221397,3800,761,3039,2280.5
salue,FALSE,6220528,3688,1288,2400,2488
acres,FALSE,6219912,3868,698,3170,2283
tenia,FALSE,6219361,3829,752,3077,2290.5
tiars,FALSE,6219256,3678,846,2832,2262
lacet,FALSE,6217984,3728,1019,2709,2373.5
seron,FALSE,6216246,3734,1033,2701,2383.5
aired,FALSE,6215950,3819,942,2877,2380.5
elain,FALSE,6215091,3810,868,2942,2339
rayne,FALSE,6213836,3769,1044,2725,2406.5
scale,TRUE,6213002,3679,1299,2380,2489
orals,FALSE,6211768,3685,813,2872,2249
train,TRUE,6210350,3610,1011,2599,2310.5
caste,TRUE,6209756,3698,1145,2553,2421.5
neals,FALSE,6207737,3781,784,2997,2282.5
toras,FALSE,6207688,3704,790,2914,2247
sorta,FALSE,6207660,3704,1011,2693,2357.5
ureas,FALSE,6206811,3877,676,3201,2276.5
inter,TRUE,6205775,3757,762,2995,2259.5
targe,FALSE,6204316,3769,1116,2653,2442.5
recta,FALSE,6203548,3917,606,3311,2261.5
urite,FALSE,6202996,3664,1129,2535,2396.5
maire,FALSE,6202697,3747,1253,2494,2500
tread,TRUE,6199799,3839,874,2965,2356.5
raits,FALSE,6198768,3678,850,2828,2264
hares,FALSE,6197942,3799,890,2909,2344.5
pearl,TRUE,6197776,3796,999,2797,2397.5
glare,TRUE,6197384,3750,1199,2551,2474.5
riels,FALSE,6196765,3806,682,3124,2244
tarsi,FALSE,6196695,3678,798,2880,2238
nerol,FALSE,6196617,3764,730,3034,2247
route,TRUE,6196304,3690,1112,2578,2401
serin,FALSE,6196226,3708,1059,2649,2383.5
stean,FALSE,6195713,3800,913,2887,2356.5
liers,FALSE,6194573,3806,655,3151,2230.5
years,FALSE,6194196,3837,743,3094,2290
aiery,FALSE,6192479,3866,1036,2830,2451
antes,FALSE,6192191,3800,693,3107,2246.5
dares,FALSE,6191207,3790,932,2858,2361
relay,TRUE,6191096,3867,986,2881,2426.5
eorls,FALSE,6190938,3832,712,3120,2272
rones,FALSE,6190703,3734,877,2857,2305.5
tamer,TRUE,6187669,3767,1044,2723,2405.5
riant,FALSE,6187584,3610,1049,2561,2329.5
marle,FALSE,6186845,3748,1160,2588,2454
rails,FALSE,6185108,3659,873,2786,2266
arils,FALSE,6184806,3659,872,2787,2265.5
erica,FALSE,6183712,3897,821,3076,2359
isnae,FALSE,6183419,3780,776,3004,2278
haole,FALSE,6183270,3665,1203,2462,2434
ratos,FALSE,6183028,3704,688,3016,2196
lairs,FALSE,6182916,3659,846,2813,2252.5
roule,FALSE,6182644,3671,1135,2536,2403
gater,FALSE,6182455,3769,1060,2709,2414.5
rased,FALSE,6181280,3790,925,2865,2357.5
arsed,FALSE,6180978,3790,924,2866,2357
morae,FALSE,6180567,3773,1136,2637,2454.5
loure,FALSE,6180452,3671,1108,2563,2389.5
larnt,FALSE,6180102,3611,990,2621,2300.5
apter,FALSE,6179707,3815,843,2972,2329
early,TRUE,6178980,3867,1065,2802,2466
crise,FALSE,6178389,3606,1326,2280,2466
mater,FALSE,6178183,3767,1052,2715,2409.5
rials,FALSE,6174546,3659,812,2847,2235.5
liars,FALSE,6172354,3659,785,2874,2222
corse,FALSE,6170511,3632,1235,2397,2433.5
sarge,FALSE,6168896,3720,1333,2387,2526.5
ayres,FALSE,6167704,3837,681,3156,2259
petar,FALSE,6166904,3815,870,2945,2342.5
toles,FALSE,6165524,3662,894,2768,2278
laris,FALSE,6164574,3659,749,2910,2204
risen,TRUE,6164356,3708,835,2873,2271.5
toran,FALSE,6163340,3636,884,2752,2260
thale,FALSE,6163270,3659,1186,2473,2422.5
shear,TRUE,6162887,3799,1062,2737,2430.5
artis,FALSE,6162706,3678,713,2965,2195.5
ramet,FALSE,6159589,3767,1041,2726,2404
armet,FALSE,6159287,3767,1040,2727,2403.5
rotas,FALSE,6159220,3704,694,3010,2199
large,TRUE,6157414,3750,1055,2695,2402.5
terns,FALSE,6157262,3728,772,2956,2250
sager,FALSE,6156837,3720,1267,2453,2493.5
hears,FALSE,6155398,3799,806,2993,2302.5
oread,FALSE,6154379,3845,766,3079,2305.5
sonar,TRUE,6153087,3587,1159,2428,2373
marse,FALSE,6153080,3718,1169,2549,2443.5
pares,FALSE,6153050,3766,963,2803,2364.5
claes,FALSE,6152733,3679,1060,2619,2369.5
argle,FALSE,6152149,3750,1061,2689,2405.5
yearn,TRUE,6149848,3769,837,2932,2303
canoe,TRUE,6149719,3636,1197,2439,2416.5
citer,FALSE,6149708,3655,1041,2614,2348
earth,TRUE,6148986,3848,817,3031,2332.5
rouse,TRUE,6148879,3641,1144,2497,2392.5
dears,FALSE,6148663,3790,848,2942,2319
solei,FALSE,6146598,3642,1086,2556,2364
ramie,FALSE,6145373,3747,1052,2695,2399.5
lager,TRUE,6145355,3750,989,2761,2369.5
trona,FALSE,6145276,3636,906,2730,2271
rines,FALSE,6144797,3708,800,2908,2254
airts,FALSE,6144682,3678,681,2997,2179.5
cleat,TRUE,6144676,3728,992,2736,2360
cates,FALSE,6142708,3698,967,2731,2332.5
resay,FALSE,6142634,3837,954,2883,2395.5
score,TRUE,6142134,3632,1226,2406,2429
inert,TRUE,6141320,3757,703,3054,2230
lamer,FALSE,6140767,3748,983,2765,2365.5
elans,FALSE,6140707,3781,798,2983,2289.5
lotes,FALSE,6139306,3662,832,2830,2247
stern,TRUE,6137267,3728,902,2826,2315
loast,FALSE,6136497,3515,1098,2417,2306.5
trans,FALSE,6135966,3581,941,2640,2261
acers,FALSE,6135069,3868,546,3322,2207
blare,TRUE,6134687,3717,1257,2460,2487
sarin,FALSE,6131708,3561,1121,2440,2341
astir,FALSE,6131696,3678,638,3040,2158
ourie,FALSE,6131368,3670,972,2698,2321
taber,FALSE,6130932,3736,1040,2696,2388
taces,FALSE,6130626,3698,863,2835,2280.5
stone,TRUE,6130564,3564,1293,2271,2428.5
crena,FALSE,6130139,3800,888,2912,2344
outre,FALSE,6130100,3690,914,2776,2302
blaer,FALSE,6129783,3717,1211,2506,2464
reins,FALSE,6128404,3708,831,2877,2269.5
toyer,FALSE,6127882,3650,987,2663,2318.5
shale,TRUE,6127850,3610,1403,2207,2506.5
outer,TRUE,6125196,3690,868,2822,2279
luter,FALSE,6123714,3665,915,2750,2290
sture,FALSE,6121588,3635,1184,2451,2409.5
stria,FALSE,6121164,3678,828,2850,2253
ceorl,FALSE,6120324,3662,992,2670,2327
crone,TRUE,6120132,3564,1315,2249,2439.5
tiles,FALSE,6119618,3636,817,2819,2226.5
loran,FALSE,6116438,3617,823,2794,2220
lyase,FALSE,6115547,3648,1013,2635,2330.5
apert,FALSE,6115252,3815,784,3031,2299.5
starn,FALSE,6115048,3581,1032,2549,2306.5
liras,FALSE,6114880,3659,652,3007,2155.5
rotan,FALSE,6114872,3636,788,2848,2212
renos,FALSE,6114493,3734,654,3080,2194
resin,TRUE,6114032,3708,715,2993,2211.5
reads,FALSE,6113423,3790,759,3031,2274.5
trode,FALSE,6113307,3603,1153,2450,2378
plate,TRUE,6113253,3626,1213,2413,2419.5
snarl,TRUE,6113051,3562,1068,2494,2315
yeast,TRUE,6112433,3667,979,2688,2323
teils,FALSE,6112078,3636,855,2781,2245.5
slade,FALSE,6111800,3601,1367,2234,2484
rents,FALSE,6110623,3728,661,3067,2194.5
pears,FALSE,6110506,3766,879,2887,2322.5
maser,FALSE,6109037,3718,1021,2697,2369.5
paren,FALSE,6108702,3698,1057,2641,2377.5
noise,TRUE,6107920,3544,1177,2367,2360.5
rapes,FALSE,6107784,3766,821,2945,2293.5
urena,FALSE,6107321,3809,723,3086,2266
teloi,FALSE,6105808,3691,646,3045,2168.5
nerts,FALSE,6105477,3728,617,3111,2172.5
aimer,FALSE,6104725,3747,934,2813,2340.5
dearn,FALSE,6104315,3722,942,2780,2332
drole,FALSE,6103837,3584,1208,2376,2396
great,TRUE,6103748,3769,975,2794,2372
estro,FALSE,6101604,3851,409,3442,2130
dealt,TRUE,6100665,3650,1075,2575,2362.5
sabre,FALSE,6100416,3687,1303,2384,2495
roans,FALSE,6099230,3587,909,2678,2248
baler,TRUE,6099074,3717,1119,2598,2418
lance,TRUE,6098229,3611,1107,2504,2359
trues,FALSE,6096846,3635,935,2700,2285
rimae,FALSE,6095679,3747,955,2792,2351
saber,FALSE,6095512,3687,1257,2430,2472
spear,TRUE,6093962,3766,979,2787,2372.5
lathe,TRUE,6093446,3659,955,2704,2307
lites,FALSE,6093400,3636,755,2881,2195.5
tarns,FALSE,6092744,3581,834,2747,2207.5
enrol,FALSE,6091777,3764,610,3154,2187
crine,FALSE,6090932,3538,1337,2201,2437.5
cries,FALSE,6089620,3606,1085,2521,2345.5
crest,TRUE,6089420,3626,1066,2560,2346
telos,FALSE,6089314,3662,671,2991,2166.5
stade,FALSE,6086383,3620,1243,2377,2431.5
escar,FALSE,6086336,3868,519,3349,2193.5
lutea,FALSE,6086262,3737,767,2970,2252
abore,FALSE,6085594,3742,977,2765,2359.5
steil,FALSE,6084137,3636,934,2702,2285
tride,FALSE,6084107,3577,1175,2402,2376
laces,FALSE,6083724,3679,802,2877,2240.5
potae,FALSE,6083290,3651,1119,2532,2385
sceat,FALSE,6082411,3698,999,2699,2348.5
cores,FALSE,6081742,3632,994,2638,2313
palet,FALSE,6080610,3626,1129,2497,2377.5
halse,FALSE,6080011,3610,1080,2530,2345
aloed,FALSE,6079721,3656,1022,2634,2339
triol,FALSE,6079662,3472,970,2502,2221
haste,TRUE,6078974,3629,1016,2613,2322.5
renay,FALSE,6078727,3769,1013,2756,2391
sated,FALSE,6077458,3620,1217,2403,2418.5
asper,FALSE,6076472,3766,745,3021,2255.5
istle,FALSE,6075768,3636,747,2889,2191.5
paise,FALSE,6075413,3576,1307,2269,2441.5
realm,TRUE,6074072,3748,858,2890,2303
heast,FALSE,6073635,3629,1042,2587,2335.5
spate,FALSE,6072585,3596,1297,2299,2446.5
denar,FALSE,6072008,3722,867,2855,2294.5
redia,FALSE,6070805,3819,644,3175,2231.5
perai,FALSE,6069526,3795,721,3074,2258
arson,TRUE,6069232,3587,750,2837,2168.5
reaps,FALSE,6069078,3766,740,3026,2253
trope,TRUE,6068962,3579,1134,2445,2356.5
gares,FALSE,6068583,3720,936,2784,2328
frate,FALSE,6068236,3676,1273,2403,2474.5
urine,TRUE,6068114,3547,1172,2375,2359.5
islet,TRUE,6066810,3636,733,2903,2184.5
maerl,FALSE,6066738,3748,896,2852,2322
alist,FALSE,6066088,3489,1032,2457,2260.5
lated,FALSE,6065976,3650,939,2711,2294.5
apres,FALSE,6065835,3766,719,3047,2242.5
prole,FALSE,6065680,3560,1239,2321,2399.5
throe,FALSE,6064880,3612,1012,2600,2312
mares,FALSE,6064311,3718,928,2790,2323
clart,FALSE,6064011,3509,1111,2398,2310
rains,FALSE,6063886,3561,893,2668,2227
arpen,FALSE,6063134,3698,914,2784,2306
entia,FALSE,6060907,3829,492,3337,2160.5
roues,FALSE,6060110,3641,903,2738,2272
tried,TRUE,6059790,3577,1118,2459,2347.5
recit,FALSE,6059222,3655,814,2841,2234.5
spale,FALSE,6058925,3577,1320,2257,2448.5
ulnae,FALSE,6058164,3620,960,2660,2290
doter,FALSE,6058097,3603,1031,2572,2317
shore,TRUE,6056982,3563,1330,2233,2446.5
segar,FALSE,6056819,3720,1050,2670,2385
salto,FALSE,6056544,3515,979,2536,2247
chare,FALSE,6055046,3629,1225,2404,2427
luser,FALSE,6054568,3616,884,2732,2250
tones,FALSE,6053155,3564,921,2643,2242.5
shoer,FALSE,6052078,3563,1284,2279,2423.5
tyler,FALSE,6050948,3625,814,2811,2219.5
yates,FALSE,6050724,3667,775,2892,2221
baser,FALSE,6050612,3687,1087,2600,2387
brane,FALSE,6050420,3619,1353,2266,2486
braes,FALSE,6049108,3687,1101,2586,2394
tails,FALSE,6047560,3489,917,2572,2203
slyer,FALSE,6047533,3576,1126,2450,2351
rants,FALSE,6046105,3581,723,2858,2152
larns,FALSE,6045842,3562,773,2789,2167.5
sieur,FALSE,6044593,3615,1039,2576,2327
tased,FALSE,6043732,3620,969,2651,2294.5
wrate,FALSE,6042911,3663,1220,2443,2441.5
etnas,FALSE,6042227,3800,487,3313,2143.5
thane,FALSE,6042048,3561,1206,2355,2383.5
presa,FALSE,6041922,3766,821,2945,2293.5
sayne,FALSE,6040868,3550,1305,2245,2427.5
noria,FALSE,6040263,3616,701,2915,2158.5
silen,FALSE,6039850,3519,1128,2391,2323.5
tripe,TRUE,6039762,3553,1156,2397,2354.5
horse,TRUE,6039729,3563,1106,2457,2334.5
roist,FALSE,6038621,3442,1074,2368,2258
oners,FALSE,6038000,3734,493,3241,2113.5
tuner,FALSE,6037563,3567,1004,2563,2285.5
sient,FALSE,6036835,3538,1180,2358,2359
rheas,FALSE,6035967,3799,625,3174,2212
cires,FALSE,6035836,3606,917,2689,2261.5
clote,FALSE,6035801,3492,1206,2286,2349
tsade,FALSE,6035535,3620,965,2655,2292.5
paste,TRUE,6034082,3596,1089,2507,2342.5
dorse,FALSE,6032994,3554,1148,2406,2351
prose,TRUE,6031915,3530,1248,2282,2389
crape,FALSE,6031606,3596,1246,2350,2421
seton,FALSE,6030230,3564,981,2583,2272.5
yales,FALSE,6030040,3648,776,2872,2212
ranis,FALSE,6029955,3561,742,2819,2151.5
rages,FALSE,6029917,3720,830,2890,2275
repla,FALSE,6029498,3796,631,3165,2213.5
cadre,FALSE,6028343,3620,1153,2467,2386.5
carol,TRUE,6028284,3515,953,2562,2234
olent,FALSE,6027812,3594,854,2740,2224
shire,TRUE,6027782,3537,1352,2185,2444.5
lepra,FALSE,6027306,3796,604,3192,2200
styre,FALSE,6027020,3595,1048,2547,2321.5
daine,FALSE,6026113,3532,1287,2245,2409.5
gears,FALSE,6026039,3720,852,2868,2286
lirot,FALSE,6025966,3472,838,2634,2155
neist,FALSE,6025906,3538,969,2569,2253.5
losen,FALSE,6025812,3545,895,2650,2220
saint,TRUE,6025178,3391,1371,2020,2381
naris,FALSE,6024809,3561,698,2863,2129.5
toper,FALSE,6023142,3579,1016,2563,2297.5
shier,FALSE,6022878,3537,1306,2231,2421.5
range,TRUE,6022795,3652,1048,2604,2350
maile,FALSE,6020439,3558,1263,2295,2410.5
seric,FALSE,6020219,3606,960,2646,2283
inlet,TRUE,6019463,3568,804,2764,2186
eards,FALSE,6019391,3790,644,3146,2217
leapt,TRUE,6018888,3626,940,2686,2283
flare,TRUE,6017621,3657,1220,2437,2438.5
eyras,FALSE,6017178,3837,457,3380,2147
regal,TRUE,6017169,3750,733,3017,2241.5
pilae,FALSE,6016700,3606,1043,2563,2324.5
sored,FALSE,6016492,3554,1244,2310,2399
retag,FALSE,6016141,3769,662,3107,2215.5
rouen,FALSE,6015762,3573,997,2576,2285
slant,TRUE,6015593,3392,1309,2083,2350.5
diane,FALSE,6015551,3532,1226,2306,2379
aruhe,FALSE,6013948,3638,1025,2613,2331.5
tuile,FALSE,6012872,3475,1187,2288,2331
ancle,FALSE,6012161,3611,870,2741,2240.5
recto,FALSE,6012150,3681,600,3081,2140.5
lapse,TRUE,6012103,3577,1045,2532,2311
hates,FALSE,6011926,3629,838,2791,2233.5
farle,FALSE,6011354,3657,1189,2468,2423
touse,FALSE,6011331,3471,1188,2283,2329.5
abler,FALSE,6011196,3717,799,2918,2258
leash,TRUE,6011143,3610,947,2663,2278.5
taroc,FALSE,6011141,3534,779,2755,2156.5
lures,FALSE,6009842,3616,791,2825,2203.5
airns,FALSE,6009800,3561,724,2837,2142.5
canes,FALSE,6009655,3581,995,2586,2288
ailed,FALSE,6009250,3630,891,2739,2260.5
cesta,FALSE,6008936,3698,723,2975,2210.5
togae,FALSE,6008625,3605,1082,2523,2343.5
cared,FALSE,6008412,3620,1101,2519,2360.5
tines,FALSE,6007249,3538,844,2694,2191
redan,FALSE,6007215,3722,715,3007,2218.5
smear,TRUE,6006249,3718,956,2762,2337
tired,FALSE,6006006,3577,950,2627,2263.5
bares,FALSE,6005886,3687,994,2693,2340.5
ceros,FALSE,6005532,3632,771,2861,2201.5
dates,FALSE,6005191,3620,880,2740,2250
salep,FALSE,6004902,3577,1156,2421,2366.5
coral,TRUE,6004476,3515,959,2556,2237
ileac,FALSE,6004183,3708,606,3102,2157
terga,FALSE,6003496,3769,694,3075,2231.5
roted,FALSE,6003444,3603,931,2672,2267
prise,FALSE,6002715,3504,1270,2234,2387
onset,TRUE,6001941,3564,779,2785,2171.5
scart,FALSE,6001746,3479,1118,2361,2298.5
certs,FALSE,6001662,3626,778,2848,2202
trois,FALSE,6001572,3442,854,2588,2148
taker,TRUE,6001252,3671,995,2676,2333
namer,FALSE,6001002,3650,932,2718,2291
tolas,FALSE,6000988,3515,739,2776,2127
claro,FALSE,6000789,3515,916,2599,2215.5
trema,FALSE,5999601,3767,725,3042,2246
notes,FALSE,5999541,3564,781,2783,2172.5
poler,FALSE,5999256,3560,1063,2497,2311.5
belar,FALSE,5999056,3717,902,2815,2309.5
riley,FALSE,5998226,3605,1101,2504,2353
lento,FALSE,5997211,3594,666,2928,2130
eclat,TRUE,5996946,3728,640,3088,2184
lased,FALSE,5996830,3601,908,2693,2254.5
olpae,FALSE,5996143,3632,887,2745,2259.5
louie,FALSE,5995704,3481,1114,2367,2297.5
hoser,FALSE,5995686,3563,958,2605,2260.5
triac,FALSE,5995211,3508,876,2632,2192
plier,TRUE,5994621,3534,1139,2395,2336.5
intel,FALSE,5993157,3568,706,2862,2137
elint,FALSE,5992641,3568,974,2594,2271
alecs,FALSE,5992598,3679,707,2972,2193
trios,FALSE,5992392,3442,850,2592,2146
hales,FALSE,5991242,3610,839,2771,2224.5
suite,TRUE,5991112,3445,1381,2064,2413
surat,FALSE,5991048,3488,1131,2357,2309.5
teins,FALSE,5990856,3538,875,2663,2206.5
yores,FALSE,5989758,3601,802,2799,2201.5
reams,FALSE,5989710,3718,758,2960,2238
urial,FALSE,5989536,3498,885,2613,2191.5
doser,FALSE,5988951,3554,1000,2554,2277
close,TRUE,5988376,3443,1238,2205,2340.5
opera,TRUE,5988064,3821,495,3326,2158
spore,TRUE,5988057,3530,1247,2283,2388.5
tawer,FALSE,5987988,3663,1009,2654,2336
rules,FALSE,5987592,3616,757,2859,2186.5
blear,FALSE,5987466,3717,926,2791,2321.5
heats,FALSE,5986800,3629,793,2836,2211
maise,FALSE,5986674,3528,1272,2256,2400
relic,TRUE,5986487,3636,648,2988,2142
sider,FALSE,5985613,3528,1173,2355,2350.5
dales,FALSE,5984507,3601,881,2720,2241
drone,TRUE,5982615,3486,1228,2258,2357
stoai,FALSE,5981210,3514,861,2653,2187.5
rosit,FALSE,5981140,3442,875,2567,2158.5
apers,FALSE,5980992,3766,567,3199,2166.5
ramen,TRUE,5980981,3650,918,2732,2284
feart,FALSE,5980536,3676,1090,2586,2383
talon,TRUE,5980448,3447,827,2620,2137
caper,TRUE,5979642,3596,1090,2506,2343
urent,FALSE,5979145,3567,912,2655,2239.5
sauce,TRUE,5979118,3488,1411,2077,2449.5
noles,FALSE,5978857,3545,782,2763,2163.5
plane,TRUE,5978371,3509,1256,2253,2382.5
safer,TRUE,5977632,3627,1225,2402,2426
farse,FALSE,5977589,3627,1198,2429,2412.5
water,TRUE,5977367,3663,1028,2635,2345.5
older,TRUE,5976590,3584,847,2737,2215.5
loper,FALSE,5976240,3560,955,2605,2257.5
tonal,TRUE,5975889,3447,886,2561,2166.5
teads,FALSE,5975875,3620,803,2817,2211.5
psoae,FALSE,5975486,3602,989,2613,2295.5
rache,FALSE,5975332,3629,917,2712,2273
rices,FALSE,5975286,3606,717,2889,2161.5
lotas,FALSE,5974770,3515,677,2838,2096
selah,FALSE,5974474,3610,1022,2588,2316
heals,FALSE,5973140,3610,816,2794,2213
afore,FALSE,5972710,3682,969,2713,2325.5
inset,FALSE,5971001,3538,772,2766,2155
socle,FALSE,5970758,3443,1287,2156,2365
sired,FALSE,5970586,3528,1167,2361,2347.5
slice,TRUE,5970463,3417,1409,2008,2413
tapes,FALSE,5970236,3596,865,2731,2230.5
pleat,TRUE,5969002,3626,936,2690,2281
paseo,FALSE,5968926,3602,902,2700,2252
olein,FALSE,5967936,3574,707,2867,2140.5
cause,TRUE,5967831,3488,1262,2226,2375
hanse,FALSE,5967642,3512,1107,2405,2309.5
stage,TRUE,5967488,3550,1250,2300,2400
leany,FALSE,5967340,3580,1183,2397,2381.5
lades,FALSE,5967131,3601,821,2780,2211
pates,FALSE,5967034,3596,911,2685,2253.5
royne,FALSE,5966854,3533,1019,2514,2276
deals,FALSE,5966405,3601,858,2743,2229.5
blate,FALSE,5966089,3547,1244,2303,2395.5
clean,TRUE,5966068,3611,869,2742,2240
saker,FALSE,5965832,3622,1212,2410,2417
louse,TRUE,5964429,3452,1127,2325,2289.5
pacer,FALSE,5964358,3596,1032,2564,2314
altos,FALSE,5963513,3515,621,2894,2068
amole,FALSE,5963450,3584,1009,2575,2296.5
bears,FALSE,5963342,3687,910,2777,2298.5
aside,TRUE,5963153,3600,916,2684,2258
coste,FALSE,5962774,3462,1120,2342,2291
lotsa,FALSE,5962737,3515,713,2802,2114
eloin,FALSE,5961965,3574,805,2769,2189.5
uraos,FALSE,5961418,3494,775,2719,2134.5
coset,FALSE,5960840,3462,1128,2334,2295
sware,FALSE,5960598,3614,1293,2321,2453.5
urali,FALSE,5960382,3498,780,2718,2139
lines,FALSE,5960347,3519,783,2736,2151
enact,TRUE,5959617,3630,871,2759,2250.5
spire,TRUE,5958857,3504,1269,2235,2386.5
nurse,TRUE,5958846,3518,981,2537,2249.5
tyres,FALSE,5957760,3595,689,2906,2142
recti,FALSE,5957606,3655,553,3102,2104
tepal,FALSE,5957488,3626,768,2858,2197
lande,FALSE,5957240,3533,1024,2509,2278.5
grace,TRUE,5956799,3550,1265,2285,2407.5
locie,FALSE,5956786,3472,1005,2467,2238.5
waler,FALSE,5956683,3644,1029,2615,2336.5
tolan,FALSE,5956640,3447,833,2614,2140
oaker,FALSE,5955832,3677,887,2790,2282
slain,TRUE,5955717,3372,1162,2210,2267
moire,FALSE,5955715,3511,1228,2283,2369.5
their,TRUE,5955113,3586,840,2746,2213
goier,FALSE,5955083,3513,1190,2323,2351.5
laker,FALSE,5954350,3652,934,2718,2293
petal,TRUE,5954286,3626,814,2812,2220
senti,FALSE,5954149,3538,897,2641,2217.5
spier,FALSE,5953953,3504,1223,2281,2363.5
nites,FALSE,5953635,3538,704,2834,2121
hayer,FALSE,5953600,3598,932,2666,2265
table,TRUE,5953578,3547,1096,2451,2321.5
trave,FALSE,5953486,3618,1193,2425,2405.5
piler,FALSE,5953350,3534,986,2548,2260
sawer,FALSE,5952568,3614,1226,2388,2420
stein,TRUE,5952519,3538,908,2630,2223
crame,FALSE,5952238,3548,1264,2284,2406
dries,FALSE,5952103,3528,998,2530,2263
drest,FALSE,5951903,3548,979,2569,2263.5
reach,TRUE,5951818,3629,945,2684,2287
anger,TRUE,5951258,3652,825,2827,2238.5
nicer,TRUE,5950959,3538,825,2713,2181.5
poser,TRUE,5950794,3530,1031,2499,2280.5
sheal,FALSE,5950269,3610,1006,2604,2308
ashet,FALSE,5949940,3629,737,2892,2183
torsi,FALSE,5949713,3442,773,2669,2107.5
steno,FALSE,5949173,3564,860,2704,2212
aloin,FALSE,5947955,3427,874,2553,2150.5
raced,FALSE,5947862,3620,901,2719,2260.5
aunes,FALSE,5947619,3590,820,2770,2205
arced,FALSE,5947560,3620,900,2720,2260
inure,FALSE,5947033,3547,862,2685,2204.5
cosie,FALSE,5946624,3442,1139,2303,2290.5
other,TRUE,5946472,3612,657,2955,2134.5
pales,FALSE,5946350,3577,912,2665,2244.5
actor,TRUE,5946074,3534,636,2898,2085
sloan,FALSE,5945785,3398,1104,2294,2251
satin,TRUE,5945692,3391,1069,2322,2230
intra,FALSE,5945341,3610,448,3162,2029
iotas,FALSE,5945312,3514,623,2891,2068.5
salon,TRUE,5945028,3398,1044,2354,2221
anode,TRUE,5945006,3558,965,2593,2261.5
utile,TRUE,5944706,3475,962,2513,2218.5
haets,FALSE,5944501,3629,725,2904,2177
prone,TRUE,5944458,3462,1259,2203,2360.5
saned,FALSE,5944405,3503,1245,2258,2374
scrat,FALSE,5944272,3479,985,2494,2232
dores,FALSE,5944225,3554,907,2647,2230.5
santo,FALSE,5944175,3417,1006,2411,2211.5
sural,FALSE,5944058,3469,1034,2435,2251.5
afire,TRUE,5943510,3656,991,2665,2323.5
lenti,FALSE,5942667,3568,619,2949,2093.5
artic,FALSE,5942351,3508,708,2800,2108
peats,FALSE,5941908,3596,866,2730,2231
truce,TRUE,5941840,3465,1157,2308,2311
lawer,FALSE,5941086,3644,948,2696,2296
cruet,FALSE,5940624,3465,1201,2264,2333
satem,FALSE,5939890,3548,1141,2407,2344.5
samel,FALSE,5939631,3529,1205,2324,2367
tiros,FALSE,5938608,3442,682,2760,2062
roils,FALSE,5938126,3423,848,2575,2135.5
lyart,FALSE,5938056,3478,823,2655,2150.5
spane,FALSE,5937703,3479,1340,2139,2409.5
carts,FALSE,5937144,3479,840,2639,2159.5
coure,FALSE,5936872,3471,1218,2253,2344.5
riled,FALSE,5936854,3558,855,2703,2206.5
coria,FALSE,5936448,3514,862,2652,2188
loirs,FALSE,5935934,3423,821,2602,2122
riots,FALSE,5935080,3442,726,2716,2084
rosed,FALSE,5934298,3554,900,2654,2227
oncer,FALSE,5934151,3564,714,2850,2139
pareu,FALSE,5932914,3605,928,2677,2266.5
honer,FALSE,5931779,3495,1017,2478,2256
agile,TRUE,5931260,3560,1005,2555,2282.5
aides,FALSE,5931089,3600,772,2828,2186
stain,TRUE,5930300,3391,1038,2353,2214.5
lenos,FALSE,5930043,3545,637,2908,2091
leads,FALSE,5928973,3601,742,2859,2171.5
litas,FALSE,5928864,3489,600,2889,2044.5
speat,FALSE,5928334,3596,1020,2576,2308
snail,TRUE,5928303,3372,1074,2298,2223
peals,FALSE,5928248,3577,889,2688,2233
rhone,FALSE,5926470,3495,1099,2396,2297
tains,FALSE,5926338,3391,937,2454,2164
satyr,TRUE,5926178,3448,996,2452,2222
tapen,FALSE,5925888,3528,959,2569,2243.5
crias,FALSE,5925084,3459,930,2529,2194.5
doner,FALSE,5925044,3486,1059,2427,2272.5
troad,FALSE,5924454,3456,941,2515,2198.5
opter,FALSE,5924343,3579,743,2836,2161
lairy,FALSE,5923976,3458,1174,2284,2316
carls,FALSE,5923484,3460,863,2597,2161.5
cedar,TRUE,5923421,3620,890,2730,2255
laden,TRUE,5922783,3533,915,2618,2224
paten,FALSE,5922686,3528,1005,2523,2266.5
notal,FALSE,5922275,3447,746,2701,2096.5
sepal,FALSE,5922068,3577,985,2592,2281
erics,FALSE,5921276,3606,793,2813,2199.5
panel,TRUE,5921251,3509,1059,2450,2284
solan,FALSE,5921220,3398,1050,2348,2224
tirls,FALSE,5921078,3417,712,2705,2064.5
trash,TRUE,5920829,3410,1033,2377,2221.5
uteri,FALSE,5920229,3664,450,3214,2057
delta,TRUE,5919881,3650,668,2982,2159
stead,TRUE,5919749,3620,901,2719,2260.5
after,TRUE,5918996,3676,790,2886,2233
repot,FALSE,5918852,3579,790,2789,2184.5
neath,FALSE,5918803,3561,864,2697,2212.5
blase,FALSE,5918664,3498,1276,2222,2387
rotls,FALSE,5918516,3443,693,2750,2068
noels,FALSE,5918456,3545,691,2854,2118
grise,FALSE,5918248,3458,1243,2215,2350.5
sable,FALSE,5918158,3498,1313,2185,2405.5
loris,FALSE,5917592,3423,724,2699,2073.5
yarto,FALSE,5916198,3503,670,2833,2086.5
rotis,FALSE,5916026,3442,689,2753,2065.5
pilea,FALSE,5915898,3606,838,2768,2222
tians,FALSE,5915776,3391,876,2515,2133.5
resty,FALSE,5915590,3595,930,2665,2262.5
ither,FALSE,5915532,3586,650,2936,2118
soyle,FALSE,5915108,3412,1260,2152,2336
loans,FALSE,5914780,3398,892,2506,2145
drail,FALSE,5913969,3411,999,2412,2205
pries,FALSE,5913946,3504,1029,2475,2266.5
prest,FALSE,5913746,3524,1010,2514,2267
treys,FALSE,5913167,3595,632,2963,2113.5
perst,FALSE,5912823,3524,971,2553,2247.5
enlit,FALSE,5912047,3568,682,2886,2125
lyres,FALSE,5910858,3576,628,2948,2102
gorse,FALSE,5910370,3484,1152,2332,2318
thole,FALSE,5910144,3423,1123,2300,2273
lenis,FALSE,5910023,3519,663,2856,2091
yrent,FALSE,5909979,3527,885,2642,2206
soger,FALSE,5909855,3484,1242,2242,2363
piert,FALSE,5909579,3553,926,2627,2239.5
payer,TRUE,5908708,3565,1005,2560,2285
vaire,FALSE,5908486,3598,1189,2409,2393.5
snort,TRUE,5906915,3345,1102,2243,2223.5
acute,TRUE,5906444,3537,909,2628,2223
morse,FALSE,5906098,3482,1144,2338,2313
pores,FALSE,5906068,3530,938,2592,2234
naled,FALSE,5905527,3533,889,2644,2211
torah,FALSE,5905094,3465,893,2572,2179
hires,FALSE,5905054,3537,788,2749,2162.5
morel,FALSE,5904599,3512,1023,2489,2267.5
rodes,FALSE,5904599,3554,813,2741,2183.5
aglet,FALSE,5902692,3580,836,2744,2208
cager,FALSE,5901775,3550,1099,2451,2324.5
clone,TRUE,5900919,3375,1249,2126,2312
acnes,FALSE,5900843,3581,674,2907,2127.5
idler,TRUE,5900710,3558,696,2862,2127
recon,FALSE,5900634,3564,665,2899,2114.5
curet,FALSE,5900522,3465,1118,2347,2291.5
smore,FALSE,5900344,3482,1224,2258,2353
eliad,FALSE,5899995,3630,820,2810,2225
rohes,FALSE,5899898,3563,747,2816,2155
taver,FALSE,5899780,3618,1032,2586,2325
acred,FALSE,5899600,3620,780,2840,2200
tiger,TRUE,5899369,3507,948,2559,2227.5
conte,FALSE,5898867,3394,1179,2215,2286.5
rhine,FALSE,5897270,3469,1121,2348,2295
peril,TRUE,5897108,3534,861,2673,2197.5
caron,FALSE,5896666,3417,927,2490,2172
aspie,FALSE,5896628,3576,797,2779,2186.5
tribe,TRUE,5896336,3474,1130,2344,2302
rhies,FALSE,5895958,3537,869,2668,2203
cotes,FALSE,5895726,3462,942,2520,2202
triad,TRUE,5895254,3430,963,2467,2196.5
cruse,FALSE,5895133,3416,1225,2191,2320.5
cairn,TRUE,5894988,3391,1050,2341,2220.5
timer,TRUE,5894781,3505,942,2563,2223.5
ronde,FALSE,5894708,3486,1016,2470,2251
strep,FALSE,5894274,3524,980,2544,2252
brace,TRUE,5894102,3517,1323,2194,2420
drape,TRUE,5894089,3518,1159,2359,2338.5
ocean,TRUE,5893803,3636,551,3085,2093.5
cruel,TRUE,5893634,3446,1104,2342,2275
euros,FALSE,5892988,3641,589,3052,2115
coast,TRUE,5892917,3315,1208,2107,2261.5
rayed,FALSE,5892212,3589,874,2715,2231.5
aroid,FALSE,5891204,3436,928,2508,2182
liens,FALSE,5891093,3519,685,2834,2102
trays,FALSE,5890948,3448,762,2686,2105
yeans,FALSE,5890716,3550,773,2777,2161.5
otary,FALSE,5890456,3503,941,2562,2222
agers,FALSE,5890289,3720,518,3202,2119
mitre,FALSE,5890199,3505,996,2509,2250.5
deary,FALSE,5889723,3589,1176,2413,2382.5
eosin,FALSE,5888938,3544,719,2825,2131.5
fares,FALSE,5888820,3627,957,2670,2292
shote,FALSE,5888384,3393,1317,2076,2355
royal,TRUE,5888276,3484,732,2752,2108
tames,FALSE,5887781,3548,868,2680,2208
arnut,FALSE,5887311,3420,882,2538,2151
baste,TRUE,5886918,3517,1120,2397,2318.5
ratus,FALSE,5886406,3488,638,2850,2063
curie,FALSE,5886306,3445,1129,2316,2287
miter,FALSE,5885295,3505,950,2555,2227.5
brose,FALSE,5884751,3451,1279,2172,2365
leaps,FALSE,5884628,3577,723,2854,2150
haute,TRUE,5884474,3468,1101,2367,2284.5
trons,FALSE,5882840,3345,878,2467,2111.5
nelis,FALSE,5882627,3519,585,2934,2052
gates,FALSE,5882567,3550,884,2666,2217
pelta,FALSE,5881724,3626,699,2927,2162.5
beast,TRUE,5881579,3517,1146,2371,2331.5
blore,FALSE,5881561,3481,1194,2287,2337.5
speal,FALSE,5881344,3577,923,2654,2250
reman,FALSE,5880963,3650,701,2949,2175.5
ahent,FALSE,5880697,3561,897,2664,2229
arcos,FALSE,5880162,3485,632,2853,2058.5
cuter,FALSE,5880134,3465,1025,2440,2245
rosti,FALSE,5879524,3442,614,2828,2028
manet,FALSE,5879502,3480,1121,2359,2300.5
phare,FALSE,5879372,3527,1169,2358,2348
diner,TRUE,5879138,3460,982,2478,2221
mates,FALSE,5878295,3548,876,2672,2212
syren,FALSE,5877992,3478,1000,2478,2239
snirt,FALSE,5877715,3319,1124,2195,2221.5
hared,FALSE,5877630,3551,972,2579,2261.5
those,TRUE,5876379,3393,1132,2261,2262.5
feral,TRUE,5876072,3657,860,2797,2258.5
sarod,FALSE,5875764,3407,1083,2324,2245
macer,FALSE,5875619,3548,997,2551,2272.5
shero,FALSE,5875591,3563,897,2666,2230
runes,FALSE,5875223,3518,784,2734,2151
coles,FALSE,5875042,3443,943,2500,2193
sutra,FALSE,5874762,3488,879,2609,2183.5
heros,FALSE,5874750,3563,642,2921,2102.5
yeard,FALSE,5873884,3589,825,2764,2207
horal,FALSE,5873694,3446,830,2616,2138
hoise,FALSE,5873323,3373,1209,2164,2291
heirs,FALSE,5873072,3537,765,2772,2151
argue,TRUE,5873057,3559,981,2578,2270
tyers,FALSE,5872917,3595,537,3058,2066
artsy,TRUE,5872491,3448,1054,2394,2251
anted,FALSE,5871879,3552,775,2777,2163.5
cline,FALSE,5871719,3349,1271,2078,2310
clies,FALSE,5870407,3417,1019,2398,2218
tepas,FALSE,5870218,3596,648,2948,2122
septa,FALSE,5870190,3596,869,2727,2232.5
pieta,FALSE,5869157,3625,724,2901,2174.5
ideal,TRUE,5868395,3630,550,3080,2090
deros,FALSE,5868015,3554,684,2870,2119
ultra,TRUE,5867433,3518,561,2957,2039.5
tardo,FALSE,5866475,3456,743,2713,2099.5
hoers,FALSE,5866117,3563,713,2850,2138
metal,TRUE,5865547,3578,779,2799,2178.5
telco,FALSE,5865282,3492,713,2779,2102.5
miler,FALSE,5864611,3486,951,2535,2218.5
drent,FALSE,5864446,3480,990,2490,2235
saver,FALSE,5864360,3569,1249,2320,2409
wares,FALSE,5863495,3614,904,2710,2259
sault,FALSE,5863144,3299,1250,2049,2274.5
sonce,FALSE,5862729,3345,1360,1985,2352.5
laird,FALSE,5862604,3411,928,2483,2169.5
tapir,TRUE,5862394,3406,881,2525,2143.5
gales,FALSE,5861883,3531,885,2646,2208
lants,FALSE,5861655,3392,706,2686,2049
nails,FALSE,5860893,3372,805,2567,2088.5
ropes,FALSE,5860802,3530,796,2734,2163
grone,FALSE,5859991,3416,1232,2184,2324
doers,FALSE,5859382,3554,755,2799,2154.5
shite,FALSE,5859184,3367,1339,2028,2353
paeon,FALSE,5859131,3534,885,2649,2209.5
auris,FALSE,5858958,3468,684,2784,2076
lepta,FALSE,5858708,3626,591,3035,2108.5
rides,FALSE,5858693,3528,736,2792,2132
noule,FALSE,5858429,3384,1067,2317,2225.5
resod,FALSE,5858088,3554,677,2877,2115.5
cadet,TRUE,5857811,3450,1148,2302,2299
males,FALSE,5857611,3529,877,2652,2203
geats,FALSE,5857441,3550,839,2711,2194.5
herls,FALSE,5857220,3538,672,2866,2105
clade,FALSE,5856738,3431,1199,2232,2315
brise,FALSE,5855551,3425,1301,2124,2363
merit,TRUE,5855359,3505,923,2582,2214
curse,TRUE,5855031,3416,1142,2274,2279
ready,TRUE,5854483,3589,1087,2502,2338
sepia,TRUE,5854040,3576,888,2688,2232
trins,FALSE,5853640,3319,900,2419,2109.5
meats,FALSE,5853169,3548,831,2717,2189.5
yenta,FALSE,5853045,3599,590,3009,2094.5
laver,FALSE,5852878,3599,971,2628,2285
padre,FALSE,5852669,3518,1097,2421,2307.5
parol,FALSE,5852610,3413,897,2516,2155
sewar,FALSE,5852550,3614,1009,2605,2311.5
meant,TRUE,5852547,3480,1091,2389,2285.5
liger,FALSE,5852467,3488,887,2601,2187.5
hotel,TRUE,5852214,3423,933,2490,2178
teams,FALSE,5852162,3548,802,2746,2175
liard,FALSE,5852042,3411,867,2544,2139
tehrs,FALSE,5850868,3557,588,2969,2072.5
speir,FALSE,5850768,3504,974,2530,2239
tules,FALSE,5850044,3446,801,2645,2123.5
cites,FALSE,5849820,3436,865,2571,2150.5
enols,FALSE,5849771,3545,601,2944,2073
telic,FALSE,5848939,3466,692,2774,2079
icers,FALSE,5848765,3606,439,3167,2022.5
scena,FALSE,5848661,3581,829,2752,2205
sober,TRUE,5848530,3451,1232,2219,2341.5
arish,FALSE,5848447,3390,984,2406,2187
clast,FALSE,5847988,3290,1130,2160,2210
orcas,FALSE,5847972,3485,563,2922,2024
spart,FALSE,5847669,3377,1139,2238,2258
sapor,FALSE,5846994,3383,1072,2311,2227.5
pelas,FALSE,5846332,3577,695,2882,2136
fears,FALSE,5846276,3627,873,2754,2250
borel,FALSE,5846174,3481,1089,2392,2285
usnea,FALSE,5845677,3590,570,3020,2080
ablet,FALSE,5845568,3547,840,2707,2193.5
crans,FALSE,5845484,3362,990,2372,2176
cabre,FALSE,5845354,3517,1135,2382,2326
toled,FALSE,5845212,3414,976,2438,2195
deans,FALSE,5845183,3503,878,2625,2190.5
style,TRUE,5844762,3406,1058,2348,2232
roble,FALSE,5844144,3481,1027,2454,2254
elsin,FALSE,5844009,3519,641,2878,2080
hoars,FALSE,5843898,3416,843,2573,2129.5
geals,FALSE,5843781,3531,862,2669,2196.5
cadie,FALSE,5843595,3430,1159,2271,2294.5
ousel,FALSE,5843432,3452,781,2671,2116.5
stray,TRUE,5842982,3448,1133,2315,2290.5
drats,FALSE,5842849,3401,860,2541,2130.5
tinas,FALSE,5842713,3391,689,2702,2040
riyal,FALSE,5842370,3458,655,2803,2056.5
drant,FALSE,5842227,3333,1120,2213,2226.5
airth,FALSE,5842088,3439,784,2655,2111.5
eniac,FALSE,5840920,3610,619,2991,2114.5
lames,FALSE,5840879,3529,807,2722,2168
caber,FALSE,5840450,3517,1089,2428,2303
aport,FALSE,5839907,3432,851,2581,2141.5
auger,FALSE,5839739,3559,924,2635,2241.5
meals,FALSE,5839509,3529,854,2675,2191.5
agone,FALSE,5839238,3488,1003,2485,2245.5
chase,TRUE,5839023,3410,1244,2166,2327
rakes,FALSE,5838912,3622,775,2847,2198.5
ostia,FALSE,5838880,3514,390,3124,1952
natis,FALSE,5838793,3391,646,2745,2018.5
ethal,FALSE,5838692,3659,477,3182,2068
trads,FALSE,5838659,3401,828,2573,2114.5
scone,TRUE,5838654,3345,1256,2089,2300.5
resid,FALSE,5838068,3528,703,2825,2115.5
trend,TRUE,5837873,3480,893,2587,2186.5
tache,FALSE,5837784,3459,961,2498,2210
tices,FALSE,5837738,3436,761,2675,2098.5
sucre,FALSE,5837536,3416,1184,2232,2300
coyer,FALSE,5837400,3431,1036,2395,2233.5
hause,FALSE,5837049,3419,1133,2286,2276
erbia,FALSE,5837006,3716,618,3098,2167
urnal,FALSE,5836873,3401,758,2643,2079.5
prial,FALSE,5836680,3387,994,2393,2190.5
ranke,FALSE,5836182,3554,1027,2527,2290.5
racon,FALSE,5836116,3417,727,2690,2072
birle,FALSE,5835532,3455,1124,2331,2289.5
heard,TRUE,5835086,3551,888,2663,2219.5
pleas,FALSE,5834742,3577,719,2858,2148
polar,TRUE,5834720,3413,908,2505,2160.5
sedan,TRUE,5834247,3503,976,2527,2239.5
solde,FALSE,5834109,3365,1250,2115,2307.5
manse,FALSE,5834011,3431,1145,2286,2288
panes,FALSE,5833981,3479,939,2540,2209
hilar,FALSE,5833706,3420,758,2662,2089
waite,FALSE,5833283,3473,1216,2257,2344.5
abers,FALSE,5833165,3687,522,3165,2104.5
pared,FALSE,5832738,3518,1045,2473,2281.5
deray,FALSE,5832249,3589,1043,2546,2316
acros,FALSE,5832202,3485,512,2973,1998.5
sehri,FALSE,5831942,3537,780,2757,2158.5
seity,FALSE,5831378,3405,1377,2028,2391
tabes,FALSE,5831044,3517,864,2653,2190.5
rugae,FALSE,5830693,3559,945,2614,2252
regna,FALSE,5830409,3652,660,2992,2156
heron,TRUE,5830402,3495,736,2759,2115.5
ulnar,FALSE,5830278,3401,748,2653,2074.5
blaes,FALSE,5829895,3498,1035,2463,2266.5
slide,TRUE,5829474,3339,1326,2013,2332.5
taupe,FALSE,5829204,3435,1092,2343,2263.5
poral,FALSE,5828802,3413,903,2510,2158
poise,TRUE,5828431,3340,1282,2058,2311
groat,FALSE,5828403,3386,1042,2344,2214
redos,FALSE,5828389,3554,590,2964,2072
oyers,FALSE,5827497,3601,429,3172,2015
enarm,FALSE,5827275,3650,660,2990,2155
salut,FALSE,5827014,3299,1117,2182,2208
biter,FALSE,5826870,3474,1016,2458,2245
rahed,FALSE,5826568,3551,854,2697,2202.5
prent,FALSE,5826289,3456,1021,2435,2238.5
lunar,TRUE,5826125,3401,788,2613,2094.5
lucre,FALSE,5826054,3446,906,2540,2176
perts,FALSE,5825988,3524,722,2802,2123
ulcer,TRUE,5825303,3446,820,2626,2133
trefa,FALSE,5825271,3676,692,2984,2184
petri,FALSE,5825064,3553,658,2895,2105.5
lunet,FALSE,5825033,3378,984,2394,2181
lacey,FALSE,5824784,3478,1130,2348,2304
unite,TRUE,5824751,3377,949,2428,2163
ravel,FALSE,5824710,3599,932,2667,2265.5
gayer,TRUE,5824241,3519,978,2541,2248.5
skear,FALSE,5824049,3622,928,2694,2275
lutes,FALSE,5823826,3446,739,2707,2092.5
tilde,TRUE,5823623,3388,956,2432,2172
nairu,FALSE,5823015,3400,760,2640,2080
corey,FALSE,5822802,3431,1322,2109,2376.5
coati,FALSE,5822576,3344,934,2410,2139
place,TRUE,5822053,3407,1226,2181,2316.5
renga,FALSE,5821975,3652,626,3026,2139
bleat,TRUE,5821838,3547,967,2580,2257
gores,FALSE,5821601,3484,911,2573,2197.5
ceils,FALSE,5821596,3417,904,2513,2160.5
penal,TRUE,5821233,3509,842,2667,2175.5
wears,FALSE,5820951,3614,820,2794,2217
narco,FALSE,5820797,3417,714,2703,2065.5
eland,FALSE,5820395,3533,880,2653,2206.5
bates,FALSE,5819870,3517,942,2575,2229.5
morne,FALSE,5818641,3414,1155,2259,2284.5
loipe,FALSE,5818576,3370,1107,2263,2238.5
kesar,FALSE,5817982,3622,717,2905,2169.5
thars,FALSE,5817754,3410,788,2622,2099
mores,FALSE,5817329,3482,903,2579,2192.5
oscar,FALSE,5816962,3485,488,2997,1986.5
roins,FALSE,5816904,3325,868,2457,2096.5
aiver,FALSE,5816836,3598,922,2676,2260
since,TRUE,5816823,3319,1283,2036,2301
remit,TRUE,5816377,3505,819,2686,2162
miser,TRUE,5816149,3456,919,2537,2187.5
grade,TRUE,5815810,3472,1182,2290,2327
minae,FALSE,5815592,3460,1035,2425,2247.5
acorn,TRUE,5815376,3417,707,2710,2062
raphe,FALSE,5814942,3527,919,2608,2223
ripes,FALSE,5814896,3504,719,2785,2111.5
radio,TRUE,5814889,3436,700,2736,2068
naker,FALSE,5814585,3554,883,2671,2218.5
slope,TRUE,5814329,3341,1285,2056,2313
teach,TRUE,5814270,3459,989,2470,2224
crost,FALSE,5814075,3243,1133,2110,2188
swear,TRUE,5813377,3614,962,2652,2288
amine,FALSE,5813028,3460,1051,2409,2255.5
ogler,FALSE,5812956,3514,695,2819,2104.5
tuyer,FALSE,5812402,3434,894,2540,2164
sithe,FALSE,5812040,3367,1131,2236,2249
amies,FALSE,5811716,3528,799,2729,2163.5
shiel,FALSE,5810260,3348,1250,2098,2299
haros,FALSE,5810232,3416,704,2712,2060
peris,FALSE,5809838,3504,741,2763,2122.5
soled,FALSE,5809792,3365,1193,2172,2279
yager,FALSE,5809791,3519,907,2612,2213
lidar,FALSE,5809595,3411,740,2671,2075.5
praos,FALSE,5808562,3383,884,2499,2133.5
hairs,FALSE,5808554,3390,827,2563,2108.5
meril,FALSE,5808369,3486,826,2660,2156
sidle,FALSE,5808259,3339,1229,2110,2284
tawie,FALSE,5808144,3473,1061,2412,2267
feria,FALSE,5808044,3656,763,2893,2209.5
samen,FALSE,5808013,3431,1179,2252,2305
reaks,FALSE,5807915,3622,745,2877,2183.5
troke,FALSE,5807799,3435,1139,2296,2287
asker,FALSE,5807600,3622,699,2923,2160.5
peans,FALSE,5807026,3479,909,2570,2194
aryls,FALSE,5806982,3429,635,2794,2032
anils,FALSE,5806561,3372,692,2680,2032
irons,FALSE,5806480,3325,763,2562,2044
crues,FALSE,5806364,3416,984,2432,2200
harts,FALSE,5806362,3410,711,2699,2060.5
slake,FALSE,5806292,3433,1353,2080,2393
coats,FALSE,5806082,3315,959,2356,2137
ryals,FALSE,5805988,3429,633,2796,2031
almes,FALSE,5805814,3529,757,2772,2143
leams,FALSE,5805260,3529,741,2788,2135
rainy,TRUE,5804946,3360,1221,2139,2290.5
prats,FALSE,5804692,3377,891,2486,2134
naric,FALSE,5804454,3391,693,2698,2042
lehrs,FALSE,5803966,3538,527,3011,2032.5
skate,TRUE,5802672,3452,1246,2206,2349
rosin,FALSE,5802532,3325,752,2573,2038.5
goner,TRUE,5802420,3416,1063,2353,2239.5
helot,FALSE,5802310,3423,808,2615,2115.5
caple,FALSE,5802288,3407,1146,2261,2276.5
carns,FALSE,5802262,3362,883,2479,2122.5
roads,FALSE,5801923,3407,796,2611,2101.5
chore,TRUE,5801920,3393,1162,2231,2277.5
birse,FALSE,5801767,3425,1133,2292,2279
nitro,FALSE,5801691,3374,560,2814,1967
toils,FALSE,5800578,3253,892,2361,2072.5
lithe,TRUE,5800558,3397,853,2544,2125
darts,FALSE,5799627,3401,753,2648,2077
tiled,FALSE,5799306,3388,899,2489,2143.5
bales,FALSE,5799186,3498,943,2555,2220.5
ronts,FALSE,5799123,3345,698,2647,2021.5
moner,FALSE,5798148,3414,1055,2359,2234.5
drice,FALSE,5797097,3358,1220,2138,2289
tosed,FALSE,5796750,3384,944,2440,2164
oldie,FALSE,5796746,3394,899,2495,2146.5
mesal,FALSE,5796401,3529,748,2781,2138.5
noirs,FALSE,5796169,3325,770,2555,2047.5
recap,TRUE,5795972,3596,622,2974,2109
celts,FALSE,5794962,3437,727,2710,2082
gator,FALSE,5794745,3386,874,2512,2130
beats,FALSE,5794744,3517,897,2620,2207
traps,FALSE,5794314,3377,809,2568,2093
toney,FALSE,5794215,3363,1249,2114,2306
harls,FALSE,5792702,3391,734,2657,2062.5
coals,FALSE,5792422,3296,982,2314,2139
pause,TRUE,5792157,3386,1206,2180,2296
anime,TRUE,5792093,3460,986,2474,2223
oleic,FALSE,5791929,3472,608,2864,2040
grail,TRUE,5791345,3341,1003,2338,2172
heist,TRUE,5791309,3367,1001,2366,2184
liber,FALSE,5791142,3455,877,2578,2166
metro,TRUE,5790869,3531,670,2861,2100.5
spite,TRUE,5790259,3334,1256,2078,2295
sprat,FALSE,5790195,3377,1006,2371,2191.5
ergot,FALSE,5790175,3533,791,2742,2162
wrote,TRUE,5789785,3427,1157,2270,2292
untie,TRUE,5788991,3377,813,2564,2095
stope,FALSE,5788912,3360,1161,2199,2260.5
pilar,FALSE,5788814,3387,831,2556,2109
email,TRUE,5787592,3558,731,2827,2144.5
raped,FALSE,5787472,3518,903,2615,2210.5
morat,FALSE,5787053,3384,965,2419,2174.5
preon,FALSE,5786433,3462,848,2614,2155
horas,FALSE,5786424,3416,710,2706,2063
tahrs,FALSE,5786350,3410,650,2760,2030
snead,FALSE,5786134,3503,911,2592,2207
boart,FALSE,5786102,3353,1164,2189,2258.5
slipe,FALSE,5785129,3315,1307,2008,2311
besat,FALSE,5784966,3517,911,2606,2214
latke,FALSE,5784785,3482,982,2500,2232
glair,FALSE,5784750,3341,993,2348,2167
repos,FALSE,5784592,3530,573,2957,2051.5
deist,FALSE,5784574,3358,1043,2315,2200.5
sited,FALSE,5784570,3358,1115,2243,2236.5
antis,FALSE,5784461,3391,533,2858,1962
redon,FALSE,5784041,3486,684,2802,2085
napes,FALSE,5783569,3479,753,2726,2116
daris,FALSE,5783477,3381,772,2609,2076.5
hosel,FALSE,5783068,3374,902,2472,2138
recut,TRUE,5782620,3465,738,2727,2101.5
getas,FALSE,5782549,3550,667,2883,2108.5
unlet,FALSE,5782523,3378,803,2575,2090.5
drain,TRUE,5782351,3313,973,2340,2143
steam,TRUE,5782181,3548,825,2723,2186.5
strad,FALSE,5781610,3401,887,2514,2144
space,TRUE,5781385,3377,1310,2067,2343.5
ideas,FALSE,5781125,3600,430,3170,2015
beals,FALSE,5781084,3498,920,2578,2209
stake,TRUE,5780875,3452,1229,2223,2340.5
rauns,FALSE,5780630,3371,792,2579,2081.5
rayon,TRUE,5780466,3386,700,2686,2043
stied,FALSE,5779740,3358,1145,2213,2251.5
alowe,FALSE,5779318,3480,1035,2445,2257.5
onery,FALSE,5779060,3533,821,2712,2177
proas,FALSE,5778610,3383,852,2531,2117.5
trike,FALSE,5778599,3409,1161,2248,2285
swale,FALSE,5778340,3425,1303,2122,2364
forte,TRUE,5778032,3440,1141,2299,2290.5
parti,FALSE,5777964,3406,759,2647,2082.5
noris,FALSE,5777827,3325,673,2652,1999
doest,FALSE,5777619,3384,991,2393,2187.5
porta,FALSE,5776924,3432,787,2645,2109.5
tawse,FALSE,5776869,3444,1074,2370,2259
walie,FALSE,5776839,3454,1081,2373,2267.5
spile,FALSE,5776599,3315,1279,2036,2297
trued,FALSE,5776534,3387,1017,2370,2202
coder,FALSE,5776457,3384,1082,2302,2233
hayle,FALSE,5776246,3409,988,2421,2198.5
argot,FALSE,5776165,3386,860,2526,2123
sorda,FALSE,5775471,3407,941,2466,2174
piers,FALSE,5775319,3504,709,2795,2106.5
ornis,FALSE,5774289,3325,641,2684,1983
angle,TRUE,5773904,3463,881,2582,2172
moile,FALSE,5773457,3322,1238,2084,2280
atoke,FALSE,5773113,3507,941,2566,2224
lited,FALSE,5773088,3388,837,2551,2112.5
cital,FALSE,5772554,3319,830,2489,2074.5
eruct,FALSE,5772280,3465,909,2556,2187
cream,TRUE,5771749,3548,847,2701,2197.5
grape,TRUE,5771465,3448,1163,2285,2305.5
mires,FALSE,5771423,3456,826,2630,2141
ashen,TRUE,5771332,3512,614,2898,2063
rueda,FALSE,5771098,3629,601,3028,2115
FALSE,TRUE,5770889,3438,1147,2291,2292.5
ripen,TRUE,5770548,3436,813,2623,2124.5
crake,FALSE,5770443,3452,1251,2201,2351.5
vares,FALSE,5770100,3569,864,2705,2216.5
scail,FALSE,5770008,3270,1027,2243,2148.5
alike,TRUE,5769330,3462,1087,2375,2274.5
cried,TRUE,5769308,3358,1167,2191,2262.5
ciels,FALSE,5768735,3417,775,2642,2096
lerps,FALSE,5768708,3505,579,2926,2042
oncet,FALSE,5768523,3394,755,2639,2074.5
brine,TRUE,5768094,3357,1312,2045,2334.5
dorsa,FALSE,5767656,3407,788,2619,2097.5
leach,TRUE,5767368,3440,928,2512,2184
suent,FALSE,5767261,3348,1164,2184,2256
snary,FALSE,5766841,3331,1276,2055,2303.5
bries,FALSE,5766782,3425,1060,2365,2242.5
raids,FALSE,5766579,3381,780,2601,2080.5
cures,FALSE,5766262,3416,901,2515,2158.5
awner,FALSE,5766069,3546,854,2692,2200
scran,FALSE,5765664,3362,862,2500,2112
feast,TRUE,5764513,3457,1109,2348,2283
madre,FALSE,5763930,3470,1062,2408,2266
siled,FALSE,5763886,3339,1116,2223,2227.5
pairs,FALSE,5763662,3357,900,2457,2128.5
laced,FALSE,5763412,3431,884,2547,2157.5
blert,FALSE,5763392,3475,956,2519,2215.5
velar,FALSE,5763270,3599,772,2827,2185.5
cesti,FALSE,5762994,3436,670,2766,2053
cones,FALSE,5762673,3345,970,2375,2157.5
barye,FALSE,5762180,3486,1067,2419,2276.5
hoast,FALSE,5762135,3246,1079,2167,2162.5
bayer,FALSE,5761544,3486,1036,2450,2261
parts,FALSE,5761470,3377,784,2593,2080.5
cored,FALSE,5761430,3384,1076,2308,2230
clats,FALSE,5761153,3290,881,2409,2085.5
write,TRUE,5760585,3401,1179,2222,2290
tical,FALSE,5760472,3319,726,2593,2022.5
anker,FALSE,5760253,3554,770,2784,2162
borne,TRUE,5760216,3383,1221,2162,2302
smart,TRUE,5759956,3329,1116,2213,2222.5
thine,FALSE,5759722,3299,1165,2134,2232
stipe,FALSE,5759712,3334,1183,2151,2258.5
rebit,FALSE,5759640,3474,815,2659,2144.5
aegis,FALSE,5759101,3530,644,2886,2087
price,TRUE,5758940,3334,1251,2083,2292.5
bores,FALSE,5758904,3451,969,2482,2210
dotes,FALSE,5758209,3384,855,2529,2119.5
yites,FALSE,5757836,3405,673,2732,2039
druse,FALSE,5757616,3338,1138,2200,2238
melas,FALSE,5757593,3529,660,2869,2094.5
slaty,FALSE,5757275,3259,1377,1882,2318
stoep,FALSE,5757068,3360,1061,2299,2210.5
riads,FALSE,5756017,3381,719,2662,2050
laity,FALSE,5755378,3288,1161,2127,2224.5
roust,FALSE,5755365,3252,973,2279,2112.5
toker,FALSE,5754270,3435,970,2465,2202.5
intro,TRUE,5753943,3374,442,2932,1908
oiled,FALSE,5753886,3394,791,2603,2092.5
cento,FALSE,5753631,3394,776,2618,2085
shone,TRUE,5753502,3276,1360,1916,2318
cased,FALSE,5753250,3401,1018,2383,2209.5
miner,TRUE,5752242,3388,978,2410,2183
amort,FALSE,5752194,3384,828,2556,2106
abies,FALSE,5751602,3497,777,2720,2137
tarps,FALSE,5751092,3377,702,2675,2039.5
scape,FALSE,5750128,3377,1187,2190,2282
raths,FALSE,5750122,3410,584,2826,1997
losed,FALSE,5749848,3365,883,2482,2124
narcs,FALSE,5749759,3362,692,2670,2027
spean,FALSE,5749726,3479,897,2582,2188
cripe,FALSE,5749280,3334,1205,2129,2269.5
salic,FALSE,5749001,3270,971,2299,2120.5
tyran,FALSE,5748876,3380,628,2752,2004
hepar,FALSE,5748842,3527,744,2783,2135.5
repay,TRUE,5748826,3565,932,2633,2248.5
lards,FALSE,5748535,3382,660,2722,2021
kiore,FALSE,5747972,3415,1042,2373,2228.5
sutor,FALSE,5747486,3252,1007,2245,2129.5
loath,TRUE,5747068,3276,952,2324,2114
hoaed,FALSE,5746568,3387,1091,2296,2239
resaw,FALSE,5746359,3614,607,3007,2110.5
molar,TRUE,5745981,3365,873,2492,2119
aygre,FALSE,5745659,3519,807,2712,2163
paris,FALSE,5745320,3357,803,2554,2080
manes,FALSE,5745242,3431,904,2527,2167.5
neaps,FALSE,5744863,3479,672,2807,2075.5
stour,FALSE,5744808,3252,981,2271,2116.5
waste,TRUE,5744527,3444,1030,2414,2237
brast,FALSE,5744363,3298,1171,2127,2234.5
goral,FALSE,5744335,3367,876,2491,2121.5
holes,FALSE,5744260,3374,814,2560,2094
toric,FALSE,5744139,3272,780,2492,2026
soave,FALSE,5743782,3405,1422,1983,2413.5
ureic,FALSE,5743262,3445,666,2779,2055.5
tabor,FALSE,5743222,3353,854,2499,2103.5
tacos,FALSE,5742916,3315,677,2638,1996
certy,FALSE,5742722,3425,1106,2319,2265.5
cheat,TRUE,5742197,3459,935,2524,2197
saunt,FALSE,5741922,3201,1270,1931,2235.5
avert,TRUE,5741337,3618,738,2880,2178
spiel,TRUE,5741335,3315,1167,2148,2241
piste,FALSE,5741194,3334,987,2347,2160.5
blart,FALSE,5741173,3328,1086,2242,2207
tower,TRUE,5741006,3427,984,2443,2205.5
moral,TRUE,5740063,3365,868,2497,2116.5
harem,TRUE,5740062,3479,896,2583,2187.5
boner,FALSE,5739723,3383,1121,2262,2252
alkie,FALSE,5739441,3462,936,2526,2199
baels,FALSE,5738785,3498,852,2646,2175
angel,TRUE,5738640,3463,769,2694,2116
frise,FALSE,5738485,3365,1264,2101,2314.5
parge,FALSE,5738160,3448,1109,2339,2278.5
twoer,FALSE,5737988,3427,967,2460,2197
sharn,FALSE,5737986,3293,1099,2194,2196
tunes,FALSE,5737675,3348,828,2520,2088
glace,FALSE,5737586,3361,1199,2162,2280
doles,FALSE,5737525,3365,856,2509,2110.5
tauon,FALSE,5737486,3256,880,2376,2068
raves,FALSE,5737440,3569,812,2757,2190.5
trems,FALSE,5737165,3476,697,2779,2086.5
genal,FALSE,5736766,3463,815,2648,2139
goers,FALSE,5736758,3484,759,2725,2121.5
radge,FALSE,5736691,3472,984,2488,2228
tragi,FALSE,5736258,3360,810,2550,2085
terms,FALSE,5736242,3476,658,2818,2067
herns,FALSE,5735998,3440,692,2748,2066
curat,FALSE,5735986,3318,963,2355,2140.5
plena,FALSE,5735252,3509,766,2743,2137.5
sieth,FALSE,5734863,3367,1023,2344,2195
nirls,FALSE,5734411,3300,600,2700,1950
shalt,TRUE,5734336,3221,1232,1989,2226.5
calos,FALSE,5734314,3296,782,2514,2039
sneap,FALSE,5734262,3479,849,2630,2164
unset,TRUE,5734061,3348,771,2577,2059.5
ragde,FALSE,5733922,3472,969,2503,2220.5
farce,TRUE,5733814,3457,1179,2278,2318
lieus,FALSE,5733223,3426,585,2841,2005.5
clame,FALSE,5733025,3359,1198,2161,2278.5
toned,FALSE,5732843,3316,1003,2313,2159.5
coper,FALSE,5732660,3360,1065,2295,2212.5
moers,FALSE,5732486,3482,751,2731,2116.5
rimes,FALSE,5732441,3456,722,2734,2089
loave,FALSE,5732300,3435,1144,2291,2289.5
aspen,FALSE,5732236,3479,663,2816,2071
souce,FALSE,5732136,3252,1386,1866,2319
atrip,FALSE,5731908,3406,595,2811,2000.5
smote,TRUE,5731746,3312,1211,2101,2261.5
beano,FALSE,5730900,3455,962,2493,2208.5
reamy,FALSE,5730770,3517,1086,2431,2301.5
cider,TRUE,5730551,3358,1005,2353,2181.5
flier,TRUE,5730391,3395,1133,2262,2264
strap,TRUE,5729738,3377,825,2552,2101
talcs,FALSE,5729726,3290,753,2537,2021.5
derns,FALSE,5729263,3431,734,2697,2082.5
argol,FALSE,5729175,3367,763,2604,2065
forel,FALSE,5729108,3421,1052,2369,2236.5
leish,FALSE,5728817,3348,906,2442,2127
boite,FALSE,5728692,3310,1281,2029,2295.5
brail,FALSE,5728648,3308,1061,2247,2184.5
talus,FALSE,5728174,3299,683,2616,1991
sopra,FALSE,5727288,3383,919,2464,2151
sheol,FALSE,5727095,3374,975,2399,2174.5
salty,TRUE,5726566,3259,1285,1974,2272
pager,FALSE,5726101,3448,1043,2405,2245.5
incle,FALSE,5725857,3349,763,2586,2056
eusol,FALSE,5725096,3452,626,2826,2039
lytes,FALSE,5724842,3406,576,2830,1991
shine,TRUE,5724302,3250,1382,1868,2316
entry,TRUE,5724279,3527,786,2741,2156.5
ament,FALSE,5724059,3480,791,2689,2135.5
hance,FALSE,5723867,3342,1088,2254,2215
faine,FALSE,5723726,3369,1312,2057,2340.5
merls,FALSE,5723589,3457,710,2747,2083.5
cades,FALSE,5723551,3401,931,2470,2166
topes,FALSE,5723254,3360,840,2520,2100
saith,FALSE,5723206,3220,1214,2006,2217
laics,FALSE,5723118,3270,846,2424,2058
algor,FALSE,5722580,3367,753,2614,2060
geans,FALSE,5722559,3433,882,2551,2157.5
apery,FALSE,5722052,3565,895,2670,2230
shoat,FALSE,5721914,3246,1170,2076,2208
sonde,FALSE,5721740,3267,1277,1990,2272
robes,FALSE,5721610,3451,795,2656,2123
tides,FALSE,5721145,3358,780,2578,2069
meris,FALSE,5721099,3456,706,2750,2081
agent,TRUE,5721069,3482,765,2717,2123.5
hoten,FALSE,5720596,3325,907,2418,2116
scent,TRUE,5720485,3339,1018,2321,2178.5
repin,FALSE,5720224,3436,693,2743,2064.5
lodes,FALSE,5720149,3365,796,2569,2080.5
potes,FALSE,5720052,3360,886,2474,2123
betas,FALSE,5719852,3517,725,2792,2121
ogres,FALSE,5719768,3484,570,2914,2027
grant,TRUE,5719603,3263,1124,2139,2193.5
nadir,TRUE,5719524,3313,786,2527,2049.5
radon,FALSE,5719523,3339,746,2593,2042.5
gaper,FALSE,5719501,3448,1007,2441,2227.5
sayed,FALSE,5719244,3370,1135,2235,2252.5
helio,FALSE,5719068,3403,639,2764,2021
motel,TRUE,5718583,3342,971,2371,2156.5
logie,FALSE,5718529,3324,1016,2308,2170
means,FALSE,5718287,3431,874,2557,2152.5
dance,TRUE,5717132,3333,1130,2203,2231.5
cines,FALSE,5716767,3319,893,2426,2106
ricey,FALSE,5716346,3405,1045,2360,2225
trams,FALSE,5714946,3329,827,2502,2078
dinar,FALSE,5714602,3313,827,2486,2070
flane,FALSE,5714141,3370,1250,2120,2310
twire,FALSE,5713692,3401,1035,2366,2218
acted,FALSE,5713584,3450,728,2722,2089
comae,FALSE,5713555,3384,1125,2259,2254.5
niger,FALSE,5712702,3390,836,2554,2113
dites,FALSE,5712303,3358,778,2580,2068
sargo,FALSE,5712160,3337,967,2370,2152
laith,FALSE,5711724,3250,936,2314,2093
ables,FALSE,5711308,3498,623,2875,2060.5
taish,FALSE,5711201,3220,1029,2191,2124.5
colas,FALSE,5710506,3296,788,2508,2042
yarns,FALSE,5710278,3331,691,2640,2011
barde,FALSE,5709891,3439,1133,2306,2286
ranid,FALSE,5709643,3313,824,2489,2068.5
dicer,FALSE,5709627,3358,899,2459,2128.5
raged,FALSE,5709605,3472,912,2560,2192
shade,TRUE,5709321,3332,1310,2022,2321
rudie,FALSE,5709163,3367,948,2419,2157.5
argil,FALSE,5709155,3341,789,2552,2065
twier,FALSE,5708788,3401,989,2412,2195
droit,TRUE,5707833,3194,1033,2161,2113.5
layed,FALSE,5707762,3400,857,2543,2128.5
yetis,FALSE,5707512,3405,553,2852,1979
swore,TRUE,5707472,3378,1230,2148,2304
adieu,FALSE,5707284,3439,746,2693,2092.5
caneh,FALSE,5707061,3342,1098,2244,2220
kaies,FALSE,5706868,3432,944,2488,2188
regos,FALSE,5706725,3484,582,2902,2033
basen,FALSE,5706376,3400,1005,2395,2202.5
scaur,FALSE,5706024,3269,1007,2262,2138
glean,TRUE,5705927,3463,786,2677,2124.5
slime,TRUE,5705761,3267,1325,1942,2296
sower,TRUE,5705586,3378,1201,2177,2289.5
worse,TRUE,5705282,3378,1120,2258,2249
canst,FALSE,5704910,3192,1065,2127,2128.5
ileus,FALSE,5704742,3426,530,2896,1978
armed,FALSE,5704715,3470,905,2565,2187.5
amrit,FALSE,5704652,3358,753,2605,2055.5
armil,FALSE,5704567,3339,783,2556,2061
plait,TRUE,5703589,3217,1061,2156,2139
sield,FALSE,5703485,3339,1025,2314,2182
gilet,FALSE,5703255,3318,1000,2318,2159
yelts,FALSE,5702978,3406,535,2871,1970.5
fates,FALSE,5702804,3457,905,2552,2181
daces,FALSE,5702627,3401,825,2576,2113
smite,TRUE,5702546,3286,1233,2053,2259.5
latus,FALSE,5701956,3299,621,2678,1960
crios,FALSE,5701910,3223,899,2324,2061
liney,FALSE,5701407,3318,1111,2207,2214.5
takes,FALSE,5701364,3452,819,2633,2135.5
octal,TRUE,5701266,3345,511,2834,1928
names,FALSE,5701114,3431,756,2675,2093.5
romal,FALSE,5701081,3365,764,2601,2064.5
sured,FALSE,5701012,3338,1151,2187,2244.5
largo,FALSE,5700678,3367,689,2678,2028
trove,TRUE,5700360,3382,1130,2252,2256
cutie,TRUE,5700290,3275,1077,2198,2176
facer,FALSE,5700128,3457,1026,2431,2241.5
tours,FALSE,5699580,3252,781,2471,2016.5
poles,FALSE,5699368,3341,887,2454,2114
crome,FALSE,5699112,3312,1201,2111,2256.5
slave,TRUE,5698853,3380,1344,2036,2362
rowie,FALSE,5698710,3407,992,2415,2199.5
moste,FALSE,5698361,3312,1029,2283,2170.5
scant,TRUE,5698266,3192,1148,2044,2170
macle,FALSE,5698265,3359,1053,2306,2206
crits,FALSE,5698040,3217,906,2311,2061.5
valet,TRUE,5697660,3429,1030,2399,2229.5
escot,FALSE,5697534,3462,529,2933,1995.5
costa,FALSE,5697436,3315,760,2555,2037.5
loric,FALSE,5697237,3253,719,2534,1986
leman,FALSE,5696513,3461,684,2777,2072.5
labor,TRUE,5696320,3334,793,2541,2063.5
slept,TRUE,5696160,3335,1047,2288,2191
simar,FALSE,5694825,3309,1004,2305,2156.5
plies,FALSE,5694733,3315,963,2352,2139
kiter,FALSE,5694258,3409,863,2546,2136
lower,TRUE,5694104,3408,923,2485,2165.5
rifte,FALSE,5694018,3414,895,2519,2154.5
culet,FALSE,5693822,3276,1067,2209,2171.5
biner,FALSE,5693817,3357,1044,2313,2200.5
ploat,FALSE,5693657,3243,1003,2240,2123
raven,TRUE,5693092,3501,906,2595,2203.5
autos,FALSE,5692962,3324,606,2718,1965
coirs,FALSE,5692354,3223,931,2292,2077
grame,FALSE,5692097,3400,1181,2219,2290.5
abort,TRUE,5692080,3353,806,2547,2079.5
atocs,FALSE,5691836,3315,650,2665,1982.5
hated,FALSE,5691614,3381,920,2461,2150.5
twaes,FALSE,5691226,3444,854,2590,2149
perns,FALSE,5691106,3407,765,2642,2086
heils,FALSE,5690814,3348,775,2573,2061.5
lunes,FALSE,5690773,3329,767,2562,2048
incel,FALSE,5690593,3349,651,2698,2000
moira,FALSE,5690377,3364,868,2496,2116
frena,FALSE,5690235,3559,826,2733,2192.5
fetal,TRUE,5690056,3487,808,2679,2147.5
decal,TRUE,5689879,3431,728,2703,2079.5
lured,FALSE,5689530,3368,873,2495,2120.5
torcs,FALSE,5689444,3243,779,2464,2011
caned,FALSE,5689343,3333,1077,2256,2205
adorn,TRUE,5689290,3339,687,2652,2013
filer,TRUE,5689120,3395,980,2415,2187.5
canto,FALSE,5689113,3247,838,2409,2042.5
smile,TRUE,5688886,3267,1256,2011,2261.5
auloi,FALSE,5688772,3334,582,2752,1958
genoa,FALSE,5688758,3488,692,2796,2090
ovate,TRUE,5688670,3454,926,2528,2190
torus,TRUE,5687892,3252,709,2543,1980.5
aleft,FALSE,5687826,3487,807,2680,2147
sabir,FALSE,5687782,3278,1097,2181,2187.5
spelt,TRUE,5687630,3335,1019,2316,2177
bolar,FALSE,5687556,3334,939,2395,2136.5
tined,FALSE,5686937,3290,926,2364,2108
cotan,FALSE,5686842,3247,881,2366,2064
banes,FALSE,5686817,3400,970,2430,2185
taube,FALSE,5685778,3356,1066,2290,2211
sadhe,FALSE,5685771,3332,1197,2135,2264.5
bared,FALSE,5685574,3439,1076,2363,2257.5
lycea,FALSE,5684714,3478,549,2929,2013.5
camel,TRUE,5684569,3359,1037,2322,2198
deils,FALSE,5684079,3339,817,2522,2078
skier,TRUE,5684040,3360,1172,2188,2266
rolag,FALSE,5683957,3367,700,2667,2033.5
puler,FALSE,5683776,3344,970,2374,2157
blite,FALSE,5683763,3285,1203,2082,2244
chert,FALSE,5683751,3387,924,2463,2155.5
ascot,TRUE,5683524,3315,598,2717,1956.5
peaty,FALSE,5682968,3395,1194,2201,2294.5
siroc,FALSE,5682833,3223,894,2329,2058.5
cents,FALSE,5682593,3339,754,2585,2046.5
grein,FALSE,5681946,3390,847,2543,2118.5
boral,FALSE,5681638,3334,934,2400,2134
rewan,FALSE,5681282,3546,666,2880,2106
dotal,FALSE,5680943,3267,820,2447,2043.5
freit,FALSE,5680791,3414,991,2423,2202.5
menta,FALSE,5680616,3480,691,2789,2085.5
rifle,TRUE,5680358,3395,918,2477,2156.5
stime,FALSE,5680344,3286,1201,2085,2243.5
capes,FALSE,5679754,3377,914,2463,2145.5
slaid,FALSE,5679753,3192,1150,2042,2171
stoln,FALSE,5679664,3156,979,2177,2067.5
volae,FALSE,5679656,3435,1021,2414,2228
fetor,FALSE,5679500,3440,833,2607,2136.5
purse,TRUE,5679357,3314,1086,2228,2200
decor,TRUE,5679323,3384,753,2631,2068.5
noted,FALSE,5679229,3316,863,2453,2089.5
gairs,FALSE,5679195,3311,873,2438,2092
roily,FALSE,5679186,3222,1176,2046,2199
brent,FALSE,5679125,3377,1052,2325,2214.5
pance,FALSE,5678975,3309,1161,2148,2235
froes,FALSE,5678916,3391,1001,2390,2196
rends,FALSE,5678434,3431,591,2840,2011
swire,FALSE,5678272,3352,1252,2100,2302
roams,FALSE,5678210,3335,795,2540,2065
feats,FALSE,5677678,3457,860,2597,2158.5
death,TRUE,5677471,3381,938,2443,2159.5
etics,FALSE,5676646,3436,603,2833,2019.5
lopes,FALSE,5676352,3341,779,2562,2060
loden,FALSE,5675801,3297,890,2407,2093.5
ribes,FALSE,5675704,3425,718,2707,2071.5
oracy,FALSE,5675288,3284,1131,2153,2207.5
shoal,TRUE,5674924,3227,1073,2154,2150
mairs,FALSE,5674923,3309,865,2444,2087
grice,FALSE,5674473,3288,1224,2064,2256
stave,TRUE,5673436,3399,1220,2179,2309.5
nerds,FALSE,5673288,3431,547,2884,1989
lifer,FALSE,5673262,3395,845,2550,2120
siker,FALSE,5672944,3360,1110,2250,2235
marts,FALSE,5672731,3329,749,2580,2039
cauri,FALSE,5672574,3298,830,2468,2064
lobar,FALSE,5672512,3334,799,2535,2066.5
plast,FALSE,5672314,3188,1074,2114,2131
aulos,FALSE,5672278,3305,607,2698,1956
super,TRUE,5672242,3314,1140,2174,2227
lotah,FALSE,5672176,3276,780,2496,2028
epris,FALSE,5672115,3504,490,3014,1997
moria,FALSE,5672035,3364,771,2593,2067.5
harns,FALSE,5671480,3293,754,2539,2023.5
nosey,TRUE,5671455,3314,1078,2236,2196
haled,FALSE,5670930,3362,921,2441,2141.5
clary,FALSE,5670811,3259,1222,2037,2240.5
spuer,FALSE,5670697,3314,1122,2192,2218
teind,FALSE,5670544,3290,957,2333,2123.5
snide,TRUE,5670442,3241,1212,2029,2226.5
padle,FALSE,5670411,3329,1107,2222,2218
teaks,FALSE,5670367,3452,789,2663,2120.5
ictal,FALSE,5670326,3319,504,2815,1911.5
leady,FALSE,5670033,3400,1070,2330,2235
crime,TRUE,5669912,3286,1223,2063,2254.5
doats,FALSE,5668565,3237,872,2365,2054.5
routs,FALSE,5668530,3252,724,2528,1988
etuis,FALSE,5668440,3445,508,2937,1976.5
cameo,TRUE,5668337,3384,939,2445,2161.5
salve,TRUE,5668144,3380,1252,2128,2316
helos,FALSE,5668050,3374,591,2783,1982.5
reign,TRUE,5667854,3390,819,2571,2104.5
ruled,FALSE,5667280,3368,839,2529,2103.5
wanle,FALSE,5666960,3357,1112,2245,2234.5
kales,FALSE,5666574,3433,790,2643,2111.5
gerah,FALSE,5665971,3481,822,2659,2151.5
rowel,FALSE,5665936,3408,884,2524,2146
aitus,FALSE,5665914,3298,572,2726,1935
spalt,FALSE,5665411,3188,1149,2039,2168.5
shape,TRUE,5664976,3308,1291,2017,2299.5
darns,FALSE,5664745,3284,796,2488,2040
krone,FALSE,5664682,3318,1137,2181,2227.5
abets,FALSE,5664567,3517,509,3008,2013
paces,FALSE,5664470,3377,856,2521,2116.5
toads,FALSE,5664375,3237,840,2397,2038.5
feals,FALSE,5664018,3438,883,2555,2160.5
sprue,FALSE,5663913,3314,1096,2218,2205
ofter,FALSE,5663632,3440,690,2750,2065
breis,FALSE,5663597,3425,811,2614,2118
short,TRUE,5663468,3174,1159,2015,2166.5
phase,TRUE,5663349,3308,1188,2120,2248
cable,TRUE,5663096,3328,1145,2183,2236.5
crave,TRUE,5663004,3399,1242,2157,2320.5
solah,FALSE,5662974,3227,1059,2168,2143
spait,FALSE,5662921,3187,1145,2042,2166
tronc,FALSE,5662485,3175,873,2302,2024
genro,FALSE,5662088,3416,706,2710,2061
geist,FALSE,5661950,3288,1047,2241,2167.5
alive,TRUE,5661891,3409,1078,2331,2243.5
chart,TRUE,5661532,3240,1054,2186,2147
liker,FALSE,5661462,3390,832,2558,2111
delos,FALSE,5661315,3365,633,2732,1999
zaire,FALSE,5661090,3484,1149,2335,2316.5
scute,FALSE,5661080,3246,1134,2112,2190
alcos,FALSE,5660949,3296,566,2730,1931
garis,FALSE,5660853,3311,776,2535,2043.5
droil,FALSE,5660843,3175,936,2239,2055.5
royst,FALSE,5660797,3212,837,2375,2024.5
crept,TRUE,5660311,3354,945,2409,2149.5
botel,FALSE,5660158,3311,1037,2274,2174
beans,FALSE,5659862,3400,940,2460,2170
grain,TRUE,5659727,3243,977,2266,2110
ochre,FALSE,5659466,3393,666,2727,2029.5
marls,FALSE,5659071,3310,772,2538,2041
brats,FALSE,5657528,3298,922,2376,2110
delts,FALSE,5657445,3359,640,2719,1999.5
manor,TRUE,5657420,3267,894,2373,2080.5
eskar,FALSE,5657074,3622,475,3147,2048.5
goras,FALSE,5657065,3337,756,2581,2046.5
taken,TRUE,5657016,3384,913,2471,2148.5
brant,FALSE,5656906,3230,1182,2048,2206
wales,FALSE,5656795,3425,853,2572,2139
taxer,FALSE,5656732,3506,995,2511,2250.5
amice,FALSE,5656710,3358,1021,2337,2189.5
upter,FALSE,5656463,3363,735,2628,2049
ergos,FALSE,5655915,3484,574,2910,2029
cloye,FALSE,5655901,3242,1070,2172,2156
spine,TRUE,5655377,3217,1299,1918,2258
goest,FALSE,5654995,3314,995,2319,2154.5
riced,FALSE,5654974,3358,799,2559,2078.5
horde,TRUE,5654965,3315,1004,2311,2159.5
rouls,FALSE,5654870,3233,747,2486,1990
ocher,FALSE,5654562,3393,620,2773,2006.5
trild,FALSE,5654550,3169,962,2207,2065.5
riems,FALSE,5654523,3456,588,2868,2022
lakes,FALSE,5654462,3433,758,2675,2095.5
vitae,FALSE,5654434,3428,943,2485,2185.5
staid,TRUE,5654336,3211,1026,2185,2118.5
staun,FALSE,5653698,3201,962,2239,2081.5
piles,FALSE,5653462,3315,810,2505,2062.5
eyots,FALSE,5652928,3431,514,2917,1972.5
heald,FALSE,5652828,3362,898,2464,2130
moras,FALSE,5652793,3335,748,2587,2041.5
lours,FALSE,5652678,3233,720,2513,1976.5
poets,FALSE,5652627,3360,773,2587,2066.5
saury,FALSE,5652202,3238,1351,1887,2294.5
valse,FALSE,5652169,3380,1054,2326,2217
thali,FALSE,5651990,3250,773,2477,2011.5
boars,FALSE,5651842,3304,947,2357,2125.5
psora,FALSE,5651702,3383,618,2765,2000.5
sined,FALSE,5651517,3241,1143,2098,2192
hosen,FALSE,5651450,3276,876,2400,2076
nache,FALSE,5651117,3342,849,2493,2095.5
trabs,FALSE,5650888,3298,783,2515,2040.5
comer,FALSE,5650205,3312,1068,2244,2190
owrie,FALSE,5649930,3407,830,2577,2118.5
taped,FALSE,5649924,3348,947,2401,2147.5
retch,TRUE,5649882,3387,749,2638,2068
groan,TRUE,5649795,3269,919,2350,2094
fries,FALSE,5649716,3365,1023,2342,2194
genas,FALSE,5649496,3433,695,2738,2064
marge,FALSE,5649421,3400,1074,2326,2237
fayre,FALSE,5649382,3426,1045,2381,2235.5
treif,FALSE,5648281,3414,777,2637,2095.5
sweat,TRUE,5647749,3444,1003,2441,2223.5
strag,FALSE,5647343,3331,810,2521,2070.5
story,TRUE,5647330,3212,1203,2009,2207.5
snake,TRUE,5647260,3335,1239,2096,2287
epact,FALSE,5647245,3426,845,2581,2135.5
beray,FALSE,5646928,3486,1105,2381,2295.5
pated,FALSE,5646722,3348,993,2355,2170.5
horst,FALSE,5646215,3174,935,2239,2054.5
tuans,FALSE,5646202,3201,860,2341,2030.5
estoc,FALSE,5645483,3462,362,3100,1912
toges,FALSE,5645387,3314,849,2465,2081.5
opine,TRUE,5645377,3272,974,2298,2123
rouge,TRUE,5645220,3323,1049,2274,2186
shyer,FALSE,5645054,3307,1069,2238,2188
diets,FALSE,5644878,3358,665,2693,2011.5
fayer,FALSE,5644478,3426,999,2427,2212.5
nabes,FALSE,5644377,3400,752,2648,2076
tidal,TRUE,5643879,3241,745,2496,1993
beard,TRUE,5643030,3439,992,2447,2215.5
krait,FALSE,5643026,3262,1005,2257,2133.5
theca,FALSE,5642611,3459,686,2773,2072.5
chair,TRUE,5642412,3220,1019,2201,2119.5
metol,FALSE,5642373,3342,748,2594,2045
pesto,TRUE,5641864,3360,661,2699,2010.5
fores,FALSE,5641838,3391,932,2459,2161.5
refit,TRUE,5641760,3414,783,2631,2098.5
canso,FALSE,5641688,3198,870,2328,2034
credo,TRUE,5641434,3384,769,2615,2076.5
noyes,FALSE,5641327,3314,699,2615,2006.5
delis,FALSE,5641295,3339,659,2680,1999
tomes,FALSE,5640799,3312,843,2469,2077.5
spade,TRUE,5640396,3299,1227,2072,2263
roach,TRUE,5640318,3246,982,2264,2114
lined,FALSE,5640035,3271,865,2406,2068
renig,FALSE,5639894,3390,685,2705,2037.5
haint,FALSE,5639334,3152,1074,2078,2113
feuar,FALSE,5639028,3466,918,2548,2192
weals,FALSE,5638693,3425,830,2595,2127.5
tynes,FALSE,5638691,3308,665,2643,1986.5
auric,FALSE,5638603,3298,679,2619,1988.5
prost,FALSE,5638401,3141,1077,2064,2109
ayont,FALSE,5638296,3216,843,2373,2029.5
speil,FALSE,5638150,3315,918,2397,2116.5
omers,FALSE,5637915,3482,444,3038,1963
troys,FALSE,5637822,3212,699,2513,1955.5
tyred,FALSE,5637448,3347,771,2576,2059
gamer,TRUE,5637046,3400,1010,2390,2205
turme,FALSE,5637036,3315,990,2325,2152.5
voter,TRUE,5636990,3382,963,2419,2172.5
legit,FALSE,5636515,3318,808,2510,2063
beaut,FALSE,5636252,3356,1057,2299,2206.5
orang,FALSE,5635967,3269,838,2431,2053.5
cains,FALSE,5635856,3172,986,2186,2079
shent,FALSE,5635333,3270,1122,2148,2196
dital,FALSE,5635037,3241,743,2498,1992
monte,FALSE,5634454,3244,1088,2156,2166
shirt,TRUE,5634268,3148,1181,1967,2164.5
onces,FALSE,5634263,3345,538,2807,1941.5
dream,TRUE,5634232,3470,760,2710,2115
apron,TRUE,5633777,3315,627,2688,1971
gruel,TRUE,5633493,3298,1021,2277,2159.5
mensa,FALSE,5633191,3431,723,2708,2077
drake,TRUE,5632926,3374,1164,2210,2269
olpes,FALSE,5632905,3341,654,2687,1997.5
apode,FALSE,5632634,3354,939,2415,2146.5
daint,FALSE,5632599,3143,1116,2027,2129.5
loins,FALSE,5632454,3136,851,2285,1993.5
olden,TRUE,5632354,3297,765,2532,2031
maron,FALSE,5632253,3267,836,2431,2051.5
prune,TRUE,5632002,3246,1180,2066,2213
diota,FALSE,5631969,3266,760,2506,2013
hones,FALSE,5631891,3276,841,2435,2058.5
tubae,FALSE,5631820,3356,979,2377,2167.5
orach,FALSE,5631634,3246,906,2340,2076
motes,FALSE,5631313,3312,851,2461,2081.5
diels,FALSE,5631218,3339,688,2651,2013.5
ardeb,FALSE,5631213,3439,812,2627,2125.5
leafs,FALSE,5630930,3438,708,2730,2073
cirls,FALSE,5630596,3198,761,2437,1979.5
lipes,FALSE,5630446,3315,702,2613,2008.5
crash,TRUE,5630347,3191,1082,2109,2136.5
patio,TRUE,5630342,3242,773,2469,2007.5
nerka,FALSE,5630216,3554,561,2993,2057.5
deash,FALSE,5630046,3332,970,2362,2151
douar,FALSE,5629915,3246,930,2316,2088
chela,FALSE,5629669,3440,745,2695,2092.5
brame,FALSE,5629400,3367,1239,2128,2303
orgia,FALSE,5628957,3366,597,2769,1981.5
youse,FALSE,5628865,3221,1045,2176,2133
hiant,FALSE,5628772,3152,1013,2139,2082.5
dures,FALSE,5628745,3338,814,2524,2076
biers,FALSE,5628155,3425,740,2685,2082.5
paoli,FALSE,5627098,3223,863,2360,2043
gluer,FALSE,5626898,3298,1011,2287,2154.5
rogue,TRUE,5626377,3323,957,2366,2140
tuina,FALSE,5626312,3230,847,2383,2038.5
hails,FALSE,5626296,3201,837,2364,2019
kores,FALSE,5626292,3386,816,2570,2101
clans,FALSE,5626271,3173,924,2249,2048.5
pelau,FALSE,5626196,3416,660,2756,2038
snipe,TRUE,5626097,3217,1193,2024,2205
paled,FALSE,5626038,3329,994,2335,2161.5
delay,TRUE,5625549,3400,992,2408,2196
yarco,FALSE,5624998,3284,683,2601,1983.5
pryse,FALSE,5624891,3274,1033,2241,2153.5
aspro,FALSE,5624640,3383,425,2958,1904
wries,FALSE,5624391,3352,970,2382,2161
wrest,TRUE,5624191,3372,951,2421,2161.5
bosie,FALSE,5623786,3261,1114,2147,2187.5
leaks,FALSE,5623465,3433,728,2705,2080.5
snoep,FALSE,5623453,3243,1071,2172,2157
owler,FALSE,5623074,3408,727,2681,2067.5
ering,FALSE,5623015,3390,828,2562,2109
ouens,FALSE,5623001,3354,622,2732,1988
thirl,FALSE,5622698,3178,867,2311,2022.5
draco,FALSE,5622687,3237,895,2342,2066
ragis,FALSE,5622187,3311,670,2641,1990.5
traik,FALSE,5621883,3262,994,2268,2128
andro,FALSE,5621090,3339,513,2826,1926
segol,FALSE,5621027,3295,963,2332,2129
curia,FALSE,5620968,3298,769,2529,2033.5
stroy,FALSE,5619808,3212,1102,2110,2157
carve,TRUE,5619782,3399,1135,2264,2267
brute,TRUE,5619720,3284,1168,2116,2226
matey,TRUE,5619355,3347,1204,2143,2275.5
pelts,FALSE,5619288,3335,671,2664,2003
caird,FALSE,5619024,3211,1038,2173,2124.5
uredo,FALSE,5618616,3393,604,2789,1998.5
monie,FALSE,5618304,3224,1107,2117,2165.5
negro,FALSE,5618276,3416,556,2860,1986
cants,FALSE,5618075,3192,816,2376,2004
pride,TRUE,5617951,3256,1168,2088,2212
nagor,FALSE,5617880,3269,752,2517,2010.5
orgue,FALSE,5617693,3323,881,2442,2102
ramis,FALSE,5617599,3309,664,2645,1986.5
datos,FALSE,5617481,3237,694,2543,1965.5
loads,FALSE,5617473,3218,779,2439,1998.5
conia,FALSE,5617379,3227,838,2389,2032.5
amuse,TRUE,5617229,3338,939,2399,2138.5
salop,FALSE,5617192,3194,970,2224,2082
plyer,FALSE,5616797,3304,902,2402,2103
shorl,FALSE,5616478,3155,1062,2093,2108.5
coley,FALSE,5616102,3242,1271,1971,2256.5
spaed,FALSE,5616079,3299,1170,2129,2234.5
spail,FALSE,5615931,3168,1048,2120,2108
lions,FALSE,5615748,3136,752,2384,1944
muter,FALSE,5615721,3315,934,2381,2124.5
wiser,TRUE,5615333,3352,895,2457,2123.5
acerb,FALSE,5615003,3517,521,2996,2019
goles,FALSE,5614901,3295,860,2435,2077.5
avise,FALSE,5614283,3379,1017,2362,2198
octas,FALSE,5613996,3315,391,2924,1853
rands,FALSE,5613916,3284,653,2631,1968.5
noils,FALSE,5613911,3136,780,2356,1958
isled,FALSE,5612238,3339,598,2741,1968.5
troak,FALSE,5611951,3288,936,2352,2112
serif,TRUE,5611938,3365,955,2410,2160
oaken,TRUE,5611596,3390,805,2585,2097.5
frail,TRUE,5611582,3248,1024,2224,2136
ergon,FALSE,5611567,3416,668,2748,2042
strew,FALSE,5611243,3372,941,2431,2156.5
thein,FALSE,5610877,3299,758,2541,2028.5
moles,FALSE,5610629,3293,852,2441,2072.5
nosed,FALSE,5610083,3267,832,2435,2049.5
aches,FALSE,5610038,3410,544,2866,1977
laxer,FALSE,5609830,3487,934,2553,2210.5
shola,FALSE,5609386,3227,980,2247,2103.5
caver,FALSE,5609298,3399,1081,2318,2240
gloat,TRUE,5609190,3197,976,2221,2086.5
dials,FALSE,5608999,3192,818,2374,2005
nards,FALSE,5608770,3284,609,2675,1946.5
scary,TRUE,5608546,3229,1229,2000,2229
grens,FALSE,5607562,3361,777,2584,2069
sayon,FALSE,5607498,3167,961,2206,2064
steak,TRUE,5607246,3452,896,2556,2174
avers,FALSE,5607077,3569,521,3048,2045
piets,FALSE,5606721,3334,696,2638,2015
surge,TRUE,5606434,3268,1215,2053,2241.5
brule,FALSE,5606060,3265,1191,2074,2228
lover,TRUE,5605896,3363,946,2417,2154.5
serow,FALSE,5605379,3378,920,2458,2149
lehua,FALSE,5605052,3449,485,2964,1967
flair,TRUE,5604987,3248,1014,2234,2131
halos,FALSE,5603532,3227,653,2574,1940
ulans,FALSE,5603453,3182,759,2423,1970.5
usage,TRUE,5603340,3340,856,2484,2098
debar,TRUE,5602915,3439,785,2654,2112
aweto,FALSE,5602847,3499,559,2940,2029
fetas,FALSE,5602786,3457,688,2769,2072.5
emirs,FALSE,5602744,3456,564,2892,2010
claut,FALSE,5602661,3129,1041,2088,2085
tansy,FALSE,5602192,3161,1127,2034,2144
wrast,FALSE,5601972,3225,1081,2144,2153
acker,FALSE,5601958,3452,723,2729,2087.5
cages,FALSE,5601887,3331,923,2408,2127
hoper,FALSE,5601878,3291,936,2355,2113.5
ropey,FALSE,5601862,3329,1124,2205,2226.5
acton,FALSE,5601838,3247,554,2693,1900.5
altho,FALSE,5601645,3276,539,2737,1907.5
trawl,TRUE,5601209,3255,904,2351,2079.5
nemas,FALSE,5601096,3431,539,2892,1985
idles,FALSE,5600822,3339,520,2819,1929.5
sweal,FALSE,5600759,3425,906,2519,2165.5
crays,FALSE,5600466,3229,811,2418,2020
smelt,TRUE,5599917,3287,996,2291,2141.5
hider,FALSE,5599769,3289,876,2413,2082.5
halts,FALSE,5599662,3221,660,2561,1940.5
tiges,FALSE,5599481,3288,772,2516,2030
apiol,FALSE,5598989,3223,756,2467,1989.5
tarok,FALSE,5598681,3288,861,2427,2074.5
loges,FALSE,5598485,3295,788,2507,2041.5
corbe,FALSE,5597976,3281,1088,2193,2184.5
gnarl,FALSE,5597848,3244,817,2427,2030.5
argon,FALSE,5597557,3269,737,2532,2003
cames,FALSE,5597299,3329,917,2412,2123
brain,TRUE,5597030,3210,1035,2175,2122.5
creak,TRUE,5596814,3452,918,2534,2185
onely,FALSE,5596802,3344,831,2513,2087.5
glade,TRUE,5596597,3283,1116,2167,2199.5
yeahs,FALSE,5596562,3379,619,2760,1999
korat,FALSE,5596016,3288,878,2410,2083
fires,FALSE,5595932,3365,855,2510,2110
flote,FALSE,5595897,3251,1144,2107,2197.5
doper,FALSE,5595143,3282,978,2304,2130
orfes,FALSE,5595046,3391,687,2704,2039
times,FALSE,5594893,3286,766,2520,2026
sport,TRUE,5594543,3141,1076,2065,2108.5
mahoe,FALSE,5594501,3315,976,2339,2145.5
paint,TRUE,5594442,3119,1147,1972,2133
boras,FALSE,5594368,3304,814,2490,2059
meaty,TRUE,5594229,3347,1159,2188,2253
lomes,FALSE,5593897,3293,782,2511,2037.5
urned,FALSE,5593827,3270,875,2395,2072.5
pried,TRUE,5593634,3256,1111,2145,2183.5
samey,FALSE,5593421,3298,1413,1885,2355.5
yeads,FALSE,5593409,3370,660,2710,2015
maist,FALSE,5593160,3139,1101,2038,2120
dalts,FALSE,5592927,3212,702,2510,1957
hades,FALSE,5592769,3332,802,2530,2067
tinge,FALSE,5592359,3220,990,2230,2105
crons,FALSE,5592358,3126,927,2199,2026.5
usher,TRUE,5592324,3347,588,2759,1967.5
dolia,FALSE,5592231,3247,724,2523,1985.5
rokes,FALSE,5591930,3386,750,2636,2068
lynes,FALSE,5591789,3289,604,2685,1946.5
frape,FALSE,5591702,3355,1184,2171,2269.5
longe,FALSE,5591363,3227,1006,2221,2116.5
barge,TRUE,5590996,3369,1140,2229,2254.5
pures,FALSE,5590588,3314,845,2469,2079.5
chile,FALSE,5590462,3178,1194,1984,2186
house,TRUE,5590067,3183,1108,2075,2145.5
whare,FALSE,5589817,3375,1110,2265,2242.5
ulyie,FALSE,5589809,3225,845,2380,2035
amens,FALSE,5589799,3431,574,2857,2002.5
gites,FALSE,5589679,3288,782,2506,2035
atony,FALSE,5589214,3216,1008,2208,2112
rudes,FALSE,5589119,3338,720,2618,2029
amirs,FALSE,5588734,3309,633,2676,1971
minar,FALSE,5587706,3241,823,2418,2032
agros,FALSE,5587422,3337,484,2853,1910.5
ketas,FALSE,5587240,3452,572,2880,2012
clues,FALSE,5587151,3227,918,2309,2072.5
pones,FALSE,5586999,3243,914,2329,2078.5
moten,FALSE,5586965,3244,945,2299,2094.5
erupt,TRUE,5586946,3363,807,2556,2085
larch,FALSE,5586930,3221,846,2375,2033.5
bread,TRUE,5586479,3439,898,2541,2168.5
chose,TRUE,5585897,3174,1181,1993,2177.5
pored,FALSE,5585756,3282,1020,2262,2151
shame,TRUE,5585608,3260,1309,1951,2284.5
trods,FALSE,5585533,3165,765,2400,1965
plats,FALSE,5585479,3188,825,2363,2006.5
mites,FALSE,5585407,3286,774,2512,2030
ratch,FALSE,5585364,3240,811,2429,2025.5
grans,FALSE,5585343,3214,907,2307,2060.5
hoary,FALSE,5584958,3215,1171,2044,2193
plant,TRUE,5584857,3120,1085,2035,2102.5
garbe,FALSE,5584817,3369,1030,2339,2199.5
hired,FALSE,5584742,3289,870,2419,2079.5
saree,FALSE,5584393,3420,1575,1845,2497.5
bayle,FALSE,5584190,3297,1092,2205,2194.5
arcus,FALSE,5583540,3269,582,2687,1925.5
fader,FALSE,5583535,3379,1045,2334,2212
splat,TRUE,5583495,3188,955,2233,2071.5
douse,FALSE,5583332,3174,1150,2024,2162
ankle,TRUE,5582899,3365,826,2539,2095.5
luger,FALSE,5582893,3298,871,2427,2084.5
dolce,FALSE,5582519,3195,1078,2117,2136.5
lathi,FALSE,5582166,3250,542,2708,1896
laids,FALSE,5582129,3192,763,2429,1977.5
actin,FALSE,5581818,3221,580,2641,1900.5
pails,FALSE,5581404,3168,910,2258,2039
spyre,FALSE,5581033,3274,1032,2242,2153
mealy,TRUE,5580569,3328,1182,2146,2255
acned,FALSE,5580531,3333,756,2577,2044.5
nodes,FALSE,5580384,3267,745,2522,2006
cutes,FALSE,5580246,3246,849,2397,2047.5
dines,FALSE,5579250,3241,806,2435,2023.5
poule,FALSE,5578940,3180,1172,2008,2176
rivet,TRUE,5578812,3356,927,2429,2141.5
pelon,FALSE,5578810,3273,758,2515,2015.5
skart,FALSE,5577756,3233,1088,2145,2160.5
smalt,FALSE,5577698,3140,1126,2014,2133
buret,FALSE,5577684,3284,1093,2191,2188.5
wetas,FALSE,5577461,3444,635,2809,2039.5
herma,FALSE,5577414,3479,606,2873,2042.5
spial,FALSE,5576799,3168,1012,2156,2090
dalis,FALSE,5576777,3192,721,2471,1956.5
finer,TRUE,5576751,3297,1007,2290,2152
alods,FALSE,5576264,3218,691,2527,1954.5
ahint,FALSE,5576152,3152,986,2166,2069
griot,FALSE,5576029,3124,1033,2091,2078.5
layin,FALSE,5575996,3171,709,2462,1940
shute,FALSE,5575928,3177,1238,1939,2207.5
maces,FALSE,5575731,3329,821,2508,2075
linac,FALSE,5575456,3202,623,2579,1912.5
leuco,FALSE,5575418,3282,705,2577,1993.5
coted,FALSE,5575414,3214,1024,2190,2119
geits,FALSE,5575115,3288,798,2490,2043
nepit,FALSE,5574617,3266,748,2518,2007
enorm,FALSE,5574149,3414,597,2817,2005.5
baron,TRUE,5573828,3236,902,2334,2069
daker,FALSE,5573253,3374,957,2417,2165.5
ramin,FALSE,5573251,3241,758,2483,1999.5
tunas,FALSE,5573139,3201,673,2528,1937
laree,FALSE,5572911,3450,1297,2153,2373.5
botes,FALSE,5572888,3281,917,2364,2099
linos,FALSE,5572637,3136,597,2539,1866.5
bairn,FALSE,5572150,3210,1025,2185,2117.5
corni,FALSE,5571774,3155,833,2322,1994
siver,FALSE,5571472,3307,1147,2160,2227
derma,FALSE,5570679,3470,648,2822,2059
wires,FALSE,5570607,3352,802,2550,2077
fleas,FALSE,5570512,3438,713,2725,2075.5
viler,FALSE,5570400,3337,887,2450,2112
creds,FALSE,5570396,3329,747,2582,2038
oints,FALSE,5570249,3155,557,2598,1856
meint,FALSE,5570221,3218,1050,2168,2134
sweir,FALSE,5570183,3352,957,2395,2154.5
boast,TRUE,5570079,3134,1183,1951,2158.5
tyros,FALSE,5570050,3212,503,2709,1857.5
scorn,TRUE,5570012,3126,932,2194,2029
fanes,FALSE,5569751,3340,933,2407,2136.5
octan,FALSE,5569648,3247,485,2762,1866
roman,FALSE,5569463,3267,738,2529,2002.5
shred,FALSE,5569084,3260,1109,2151,2184.5
festa,FALSE,5569032,3457,661,2796,2059
lints,FALSE,5568767,3130,604,2526,1867
crout,FALSE,5568748,3082,1044,2038,2063
sluit,FALSE,5568743,3037,1143,1894,2090
karst,FALSE,5568529,3233,911,2322,2072
fared,FALSE,5568508,3379,1039,2340,2209
tuber,TRUE,5568470,3284,922,2362,2103
cosey,FALSE,5567640,3212,1239,1973,2225.5
tamed,FALSE,5567469,3300,950,2350,2125
pleon,FALSE,5567220,3273,782,2491,2027.5
oaths,FALSE,5567154,3246,520,2726,1883
swart,FALSE,5567084,3225,1122,2103,2173.5
flite,FALSE,5566697,3225,1166,2059,2195.5
hosta,FALSE,5566654,3246,631,2615,1938.5
ryots,FALSE,5566522,3212,547,2665,1879.5
spent,TRUE,5566408,3237,1039,2198,2138
sofar,FALSE,5566114,3244,1045,2199,2144.5
laths,FALSE,5565672,3221,567,2654,1894
organ,TRUE,5565367,3269,668,2601,1968.5
spirt,FALSE,5565343,3115,1098,2017,2106.5
livre,FALSE,5564894,3337,915,2422,2126
nuder,FALSE,5564792,3270,828,2442,2049
miles,FALSE,5564723,3267,775,2492,2021
bluer,TRUE,5564201,3265,1069,2196,2167
antic,TRUE,5564106,3221,528,2693,1874.5
vales,FALSE,5563400,3380,813,2567,2096.5
unais,FALSE,5563153,3181,621,2560,1901
daric,FALSE,5563122,3211,767,2444,1989
frets,FALSE,5562681,3385,755,2630,2070
tapis,FALSE,5562506,3187,705,2482,1946
shule,FALSE,5562268,3158,1261,1897,2209.5
gated,FALSE,5562255,3302,966,2336,2134
plage,FALSE,5562169,3259,1150,2109,2204.5
weary,TRUE,5562011,3413,1148,2265,2280.5
terfs,FALSE,5561912,3385,625,2760,2005
besot,FALSE,5561792,3281,880,2401,2080.5
drome,FALSE,5561595,3234,1114,2120,2174
derth,FALSE,5561551,3309,794,2515,2051.5
towie,FALSE,5561162,3237,1036,2201,2136.5
rabis,FALSE,5560862,3278,660,2618,1969
orcin,FALSE,5560430,3155,652,2503,1903.5
liver,TRUE,5559990,3337,869,2468,2103
pilao,FALSE,5559964,3223,677,2546,1950
bonie,FALSE,5559879,3193,1173,2020,2183
apted,FALSE,5559507,3348,749,2599,2048.5
halon,FALSE,5559184,3159,747,2412,1953
warst,FALSE,5558750,3225,974,2251,2099.5
garni,FALSE,5558615,3243,775,2468,2009
decan,FALSE,5558261,3333,702,2631,2017.5
wader,FALSE,5558210,3366,992,2374,2179
mated,FALSE,5557983,3300,958,2342,2129
stend,FALSE,5557823,3261,920,2341,2090.5
seamy,FALSE,5557802,3298,1347,1951,2322.5
eidos,FALSE,5557389,3364,517,2847,1940.5
naive,TRUE,5557191,3311,1077,2234,2194
abuse,TRUE,5557115,3307,917,2390,2112
frati,FALSE,5556956,3267,860,2407,2063.5
singe,TRUE,5556939,3171,1207,1964,2189
rutin,FALSE,5556198,3158,690,2468,1924
aunts,FALSE,5556039,3201,641,2560,1921
treks,FALSE,5555370,3380,684,2696,2032
loued,FALSE,5555348,3204,968,2236,2086
corns,FALSE,5555280,3126,858,2268,1992
chiel,FALSE,5555198,3178,1082,2096,2130
folie,FALSE,5555182,3231,1109,2122,2170
runed,FALSE,5554911,3270,866,2404,2068
coled,FALSE,5554730,3195,1025,2170,2110
heads,FALSE,5554611,3332,723,2609,2027.5
snath,FALSE,5554589,3123,1038,2085,2080.5
goels,FALSE,5554500,3295,769,2526,2032
oaves,FALSE,5554472,3405,748,2657,2076.5
kanes,FALSE,5554205,3335,817,2518,2076
surah,FALSE,5554194,3200,1017,2183,2108.5
yealm,FALSE,5554058,3328,759,2569,2043.5
peons,FALSE,5553900,3243,846,2397,2044.5
ligne,FALSE,5553891,3201,963,2238,2082
alefs,FALSE,5553566,3438,590,2848,2014
ident,FALSE,5553459,3290,666,2624,1978
remap,FALSE,5553127,3446,627,2819,2036.5
mesto,FALSE,5553125,3312,626,2686,1969
laves,FALSE,5552990,3380,795,2585,2087.5
dorts,FALSE,5552645,3165,728,2437,1946.5
boles,FALSE,5552204,3262,918,2344,2090
yerba,FALSE,5552154,3486,499,2987,1992.5
redly,FALSE,5551919,3328,948,2380,2138
hents,FALSE,5551811,3270,625,2645,1947.5
dural,FALSE,5551479,3221,779,2442,2000
netop,FALSE,5551147,3292,578,2714,1935
scray,FALSE,5551072,3229,1096,2133,2162.5
huers,FALSE,5550637,3347,620,2727,1983.5
meath,FALSE,5550575,3309,934,2375,2121.5
clied,FALSE,5550095,3169,1101,2068,2135
keros,FALSE,5550082,3386,593,2793,1989.5
edits,FALSE,5549850,3358,533,2825,1945.5
varec,FALSE,5549745,3399,859,2540,2129
under,TRUE,5549678,3270,725,2545,1997.5
hairy,TRUE,5549614,3189,1155,2034,2172
ecrus,FALSE,5549590,3416,393,3023,1904.5
inerm,FALSE,5549180,3388,492,2896,1940
odals,FALSE,5549142,3218,566,2652,1892
pagle,FALSE,5548747,3259,1099,2160,2179
ohias,FALSE,5548454,3226,650,2576,1938
keirs,FALSE,5548404,3360,716,2644,2038
vireo,FALSE,5548250,3362,784,2578,2073
limes,FALSE,5547991,3267,705,2562,1986
ditas,FALSE,5547767,3211,623,2588,1917
irony,TRUE,5547540,3124,1091,2033,2107.5
blest,FALSE,5547369,3256,975,2281,2115.5
sprit,FALSE,5547001,3115,1001,2114,2058
muser,FALSE,5546575,3266,903,2363,2084.5
bloat,TRUE,5546493,3164,1034,2130,2099
grues,FALSE,5546223,3268,901,2367,2084.5
yrapt,FALSE,5546108,3176,883,2293,2029.5
urson,FALSE,5545988,3135,642,2493,1888.5
goats,FALSE,5545941,3167,876,2291,2021.5
elops,FALSE,5545929,3341,603,2738,1972
praty,FALSE,5545752,3176,1219,1957,2197.5
veals,FALSE,5545298,3380,790,2590,2085
yurta,FALSE,5545134,3287,558,2729,1922.5
dents,FALSE,5545076,3261,667,2594,1964
faery,FALSE,5545037,3426,1133,2293,2279.5
brens,FALSE,5544865,3328,835,2493,2081.5
laevo,FALSE,5544765,3435,673,2762,2054
wanes,FALSE,5544426,3327,880,2447,2103.5
matlo,FALSE,5544093,3195,742,2453,1968.5
loche,FALSE,5543900,3204,875,2329,2039.5
aidos,FALSE,5543379,3217,586,2631,1901.5
court,TRUE,5543358,3082,1047,2035,2064.5
carny,FALSE,5543322,3161,1211,1950,2186
horis,FALSE,5543230,3154,705,2449,1929.5
wared,FALSE,5543183,3366,986,2380,2176
dairy,TRUE,5542879,3180,1197,1983,2188.5
yrneh,FALSE,5542379,3239,869,2370,2054
sabot,FALSE,5542174,3134,1112,2022,2123
besit,FALSE,5541772,3255,906,2349,2080.5
moats,FALSE,5541669,3165,868,2297,2016.5
galed,FALSE,5541571,3283,967,2316,2125
pines,FALSE,5541093,3217,837,2380,2027
sowar,FALSE,5541050,3231,1046,2185,2138.5
dosai,FALSE,5541021,3217,644,2573,1930.5
tends,FALSE,5540886,3261,635,2626,1948
roped,FALSE,5540490,3282,878,2404,2080
frats,FALSE,5540462,3238,885,2353,2061.5
weros,FALSE,5540303,3378,656,2722,2017
adios,FALSE,5539710,3217,595,2622,1906
weirs,FALSE,5538625,3352,779,2573,2065.5
palis,FALSE,5538620,3168,752,2416,1960
paedo,FALSE,5538458,3354,750,2604,2052
maple,TRUE,5537875,3257,1055,2202,2156
ounce,TRUE,5537249,3184,942,2242,2063
lobes,FALSE,5537160,3262,778,2484,2020
tardy,TRUE,5536497,3200,1049,2151,2124.5
doris,FALSE,5536495,3145,747,2398,1946
thens,FALSE,5536493,3270,688,2582,1979
trews,FALSE,5536158,3372,654,2718,2013
adits,FALSE,5535840,3211,602,2609,1906.5
beaty,FALSE,5535804,3316,1225,2091,2270.5
stand,TRUE,5535604,3114,1050,2064,2082
danio,FALSE,5535446,3149,770,2379,1959.5
loupe,FALSE,5535320,3180,1006,2174,2093
pedal,TRUE,5535129,3329,778,2551,2053.5
metis,FALSE,5535083,3286,654,2632,1970
tegua,FALSE,5534991,3389,604,2785,1996.5
gelts,FALSE,5534821,3289,644,2645,1966.5
percs,FALSE,5534788,3305,735,2570,2020
unred,FALSE,5534651,3270,719,2551,1994.5
sdein,FALSE,5534523,3241,851,2390,2046
facet,TRUE,5534500,3287,1067,2220,2177
nides,FALSE,5534478,3241,668,2573,1954.5
rowen,FALSE,5534318,3310,858,2452,2084
doura,FALSE,5534017,3246,771,2475,2008.5
blade,TRUE,5533900,3250,1174,2076,2212
gride,FALSE,5533484,3210,1141,2069,2175.5
coaly,FALSE,5533482,3095,1310,1785,2202.5
reifs,FALSE,5533054,3365,684,2681,2024.5
suber,FALSE,5533050,3235,1139,2096,2187
diary,TRUE,5532317,3180,1136,2044,2158
hable,FALSE,5532314,3259,1016,2243,2137.5
goals,FALSE,5532281,3148,899,2249,2023.5
burse,FALSE,5532193,3235,1117,2118,2176
toaze,FALSE,5531830,3340,1179,2161,2259.5
rivel,FALSE,5531822,3337,830,2507,2083.5
afrit,FALSE,5531654,3267,723,2544,1995
horme,FALSE,5531252,3243,1003,2240,2123
idant,FALSE,5531240,3143,796,2347,1969.5
libra,FALSE,5530708,3308,563,2745,1935.5
melts,FALSE,5530549,3287,636,2651,1961.5
ulnas,FALSE,5530390,3182,572,2610,1877
tuple,FALSE,5530308,3174,979,2195,2076.5
turns,FALSE,5530282,3129,716,2413,1922.5
clipe,FALSE,5530067,3145,1139,2006,2142
towse,FALSE,5529887,3208,1049,2159,2128.5
owres,FALSE,5529886,3378,602,2776,1990
verst,FALSE,5529873,3327,872,2455,2099.5
cited,FALSE,5529508,3188,947,2241,2067.5
novae,FALSE,5529481,3337,952,2385,2144.5
ysame,FALSE,5529356,3298,821,2477,2059.5
hoyle,FALSE,5529264,3173,963,2210,2068
denis,FALSE,5528926,3241,686,2555,1963.5
ruble,FALSE,5528664,3265,934,2331,2099.5
ayelp,FALSE,5528419,3376,559,2817,1967.5
towel,TRUE,5528388,3238,928,2310,2083
ethos,TRUE,5528248,3393,326,3067,1859.5
sowle,FALSE,5528232,3189,1257,1932,2223
stoke,TRUE,5527749,3216,1166,2050,2191
idola,FALSE,5527512,3247,524,2723,1885.5
chars,FALSE,5527272,3191,837,2354,2014
yaird,FALSE,5527040,3180,846,2334,2013
bathe,TRUE,5527028,3278,1040,2238,2159
bites,FALSE,5526982,3255,840,2415,2047.5
inarm,FALSE,5526961,3241,622,2619,1931.5
alews,FALSE,5526889,3425,580,2845,2002.5
nasty,TRUE,5526857,3161,924,2237,2042.5
avine,FALSE,5526826,3311,1028,2283,2169.5
rehab,TRUE,5526796,3448,530,2918,1989
stark,TRUE,5526581,3233,1015,2218,2124
lunas,FALSE,5526237,3182,612,2570,1897
gaols,FALSE,5526137,3148,861,2287,2004.5
ecads,FALSE,5526073,3401,524,2877,1962.5
creps,FALSE,5526051,3305,728,2577,2016.5
reiks,FALSE,5525589,3360,704,2656,2032
drave,FALSE,5525487,3321,1155,2166,2238
agues,FALSE,5525470,3340,672,2668,2006
swole,FALSE,5525214,3189,1240,1949,2214.5
blast,TRUE,5525150,3109,1105,2004,2107
plain,TRUE,5524981,3100,938,2162,2019
grist,FALSE,5524734,3069,1072,1997,2070.5
peins,FALSE,5524700,3217,868,2349,2042.5
filar,FALSE,5524584,3248,825,2423,2036.5
tsadi,FALSE,5524255,3211,552,2659,1881.5
coits,FALSE,5523756,3053,918,2135,1985.5
hoard,TRUE,5523586,3168,925,2243,2046.5
filet,TRUE,5523492,3225,1021,2204,2123
resow,FALSE,5523185,3378,576,2802,1977
agrin,FALSE,5523054,3243,604,2639,1923.5
cetyl,FALSE,5523016,3236,710,2526,1973
brans,FALSE,5522646,3181,965,2216,2073
glent,FALSE,5522609,3221,928,2293,2074.5
freon,FALSE,5522203,3323,842,2481,2082.5
slued,FALSE,5521901,3149,1168,1981,2158.5
pawer,FALSE,5521832,3342,1002,2340,2172
print,TRUE,5521744,3047,1110,1937,2078.5
duars,FALSE,5521683,3191,792,2399,1991.5
copse,TRUE,5521541,3141,1130,2011,2135.5
cardi,FALSE,5521449,3211,745,2466,1978
luces,FALSE,5521262,3227,684,2543,1955.5
opals,FALSE,5521151,3194,607,2587,1900.5
payor,FALSE,5520998,3182,819,2363,2000.5
lemur,TRUE,5520953,3296,685,2611,1990.5
stude,FALSE,5520801,3168,1101,2067,2134.5
piano,TRUE,5520658,3125,891,2234,2008
lamed,FALSE,5520567,3281,889,2392,2085
skite,FALSE,5520346,3190,1205,1985,2197.5
thorn,TRUE,5520280,3106,819,2287,1962.5
pecan,TRUE,5520104,3309,733,2576,2021
staig,FALSE,5520069,3141,949,2192,2045
noble,TRUE,5519929,3194,959,2235,2076.5
eilds,FALSE,5519803,3339,491,2848,1915
roids,FALSE,5519597,3145,755,2390,1950
rhyne,FALSE,5519446,3239,884,2355,2061.5
homer,TRUE,5519423,3243,939,2304,2091
raked,FALSE,5518600,3374,857,2517,2115.5
daurs,FALSE,5518563,3191,768,2423,1979.5
grope,TRUE,5518339,3212,1100,2112,2156
arked,FALSE,5518298,3374,856,2518,2115
weans,FALSE,5517471,3327,850,2477,2088.5
ticed,FALSE,5517426,3188,843,2345,2015.5
amide,FALSE,5515721,3280,938,2342,2109
lapis,FALSE,5515604,3168,644,2524,1906
clour,FALSE,5515163,3063,937,2126,2000
patin,FALSE,5514956,3119,845,2274,1982
ports,FALSE,5514488,3141,759,2382,1950
sepad,FALSE,5514486,3299,947,2352,2123
plead,TRUE,5514430,3329,801,2528,2065
thans,FALSE,5514274,3123,818,2305,1970.5
arefy,FALSE,5513839,3426,984,2442,2205
paned,FALSE,5513669,3231,1021,2210,2126
panto,FALSE,5513439,3145,782,2363,1963.5
denay,FALSE,5513180,3302,1019,2283,2160.5
ogles,FALSE,5513068,3295,519,2776,1907
frame,TRUE,5512334,3307,1202,2105,2254.5
moder,FALSE,5512044,3234,991,2243,2112.5
trips,FALSE,5511988,3115,768,2347,1941.5
praus,FALSE,5511940,3167,834,2333,2000.5
rangi,FALSE,5511515,3243,635,2608,1939
lotic,FALSE,5511221,3083,667,2416,1875
ribas,FALSE,5511168,3278,563,2715,1920.5
fiers,FALSE,5511089,3365,703,2662,2034
astun,FALSE,5510858,3201,480,2721,1840.5
dulse,FALSE,5510814,3149,1004,2145,2076.5
owner,TRUE,5510705,3310,754,2556,2032
gaits,FALSE,5510597,3141,860,2281,2000.5
gnars,FALSE,5510578,3214,697,2517,1955.5
crude,TRUE,5510369,3168,1123,2045,2145.5
abris,FALSE,5510278,3278,514,2764,1896
heaps,FALSE,5510266,3308,704,2604,2006
taigs,FALSE,5510136,3141,831,2310,1986
coils,FALSE,5510096,3034,941,2093,1987.5
raupo,FALSE,5510016,3222,682,2540,1952
yages,FALSE,5509903,3300,731,2569,2015.5
craig,FALSE,5509637,3141,971,2170,2056
pitas,FALSE,5509610,3187,654,2533,1920.5
agley,FALSE,5509492,3330,947,2383,2138.5
suety,FALSE,5508943,3215,1232,1983,2223.5
krais,FALSE,5508766,3213,788,2425,2000.5
trigo,FALSE,5508476,3124,816,2308,1970
sewan,FALSE,5508314,3327,927,2400,2127
glaur,FALSE,5508148,3151,917,2234,2034
reply,TRUE,5508122,3304,931,2373,2117.5
clots,FALSE,5508027,3054,818,2236,1936
toyed,FALSE,5507682,3183,893,2290,2038
refis,FALSE,5507500,3365,566,2799,1965.5
yodle,FALSE,5507119,3164,946,2218,2055
gleis,FALSE,5507081,3269,687,2582,1978
pents,FALSE,5506919,3237,698,2539,1967.5
doilt,FALSE,5506839,3005,1071,1934,2038
dirts,FALSE,5506739,3139,651,2488,1895
lohan,FALSE,5506564,3159,669,2490,1914
strop,FALSE,5506564,3141,794,2347,1967.5
nugae,FALSE,5506478,3272,877,2395,2074.5
urges,FALSE,5506371,3268,721,2547,1994.5
biles,FALSE,5506298,3236,841,2395,2038.5
cosed,FALSE,5506268,3165,993,2172,2079
soily,FALSE,5506218,3003,1437,1566,2220
serum,TRUE,5506092,3266,895,2371,2080.5
puers,FALSE,5505745,3314,693,2621,2003.5
boets,FALSE,5505463,3281,804,2477,2042.5
hains,FALSE,5505074,3103,857,2246,1980
outed,FALSE,5504996,3223,774,2449,1998.5
cards,FALSE,5504955,3182,770,2412,1976
ascon,FALSE,5504916,3198,475,2723,1836.5
stirp,FALSE,5504886,3115,917,2198,2016
aleph,FALSE,5504670,3338,708,2630,2023
agist,FALSE,5503981,3141,843,2298,1992
craps,FALSE,5503832,3158,858,2300,2008
coney,FALSE,5503733,3144,1298,1846,2221
limen,FALSE,5503643,3199,799,2400,1999
luted,FALSE,5503514,3198,821,2377,2009.5
almeh,FALSE,5503220,3290,860,2430,2075
trank,FALSE,5503151,3165,1018,2147,2091.5
nodal,FALSE,5503118,3150,710,2440,1930
couta,FALSE,5502936,3154,845,2309,1999.5
party,TRUE,5502530,3176,1112,2064,2144
beaus,FALSE,5501992,3307,840,2467,2073.5
mures,FALSE,5501849,3266,810,2456,2038
crust,TRUE,5501619,3027,1054,1973,2040.5
lords,FALSE,5501553,3146,635,2511,1890.5
pruta,FALSE,5501546,3216,777,2439,1996.5
ruins,FALSE,5501424,3109,775,2334,1942
gored,FALSE,5501289,3236,993,2243,2114.5
stoic,TRUE,5501167,3053,876,2177,1964.5
faros,FALSE,5501110,3244,771,2473,2007.5
bract,FALSE,5500588,3128,1152,1976,2140
norma,FALSE,5500511,3267,611,2656,1939
navel,TRUE,5500495,3312,864,2448,2088
spred,FALSE,5500159,3227,1026,2201,2126.5
bated,FALSE,5499558,3269,1024,2245,2146.5
inula,FALSE,5499437,3211,512,2699,1861.5
fairs,FALSE,5499432,3218,894,2324,2056
giant,TRUE,5499413,3073,1059,2014,2066
flora,TRUE,5499157,3274,797,2477,2035.5
spice,TRUE,5499059,3115,1269,1846,2192
reate,FALSE,5498377,3469,1217,2252,2343
adept,TRUE,5498111,3348,641,2707,1994.5
farts,FALSE,5497240,3238,778,2460,2008
scope,TRUE,5497002,3141,1124,2017,2132.5
inept,TRUE,5496188,3266,601,2665,1933.5
swile,FALSE,5496014,3163,1262,1901,2212.5
reink,FALSE,5495589,3292,908,2384,2100
kiers,FALSE,5495543,3360,587,2773,1973.5
tomia,FALSE,5495505,3194,711,2483,1952.5
ashed,FALSE,5495368,3332,602,2730,1967
scarp,FALSE,5495302,3158,921,2237,2039.5
rangs,FALSE,5495021,3214,660,2554,1937
borna,FALSE,5494878,3236,861,2375,2048.5
riped,FALSE,5494584,3256,801,2455,2028.5
raxes,FALSE,5494392,3457,775,2682,2116
stipa,FALSE,5494374,3187,823,2364,2005
antsy,FALSE,5494246,3161,874,2287,2017.5
prime,TRUE,5494238,3184,1167,2017,2175.5
seare,FALSE,5494007,3420,1491,1929,2455.5
eldin,FALSE,5493998,3271,636,2635,1953.5
lends,FALSE,5493984,3242,574,2668,1908
loams,FALSE,5493760,3146,778,2368,1962
estop,FALSE,5493654,3360,387,2973,1873.5
rubel,FALSE,5493400,3265,822,2443,2043.5
spule,FALSE,5493343,3125,1178,1947,2151.5
ybore,FALSE,5493184,3250,842,2408,2046
dirls,FALSE,5493079,3120,674,2446,1897
onlay,FALSE,5492667,3197,767,2430,1982
mails,FALSE,5492665,3120,875,2245,1997.5
beath,FALSE,5492150,3278,1000,2278,2139
fouer,FALSE,5492064,3230,1110,2120,2170
acrid,TRUE,5491870,3211,620,2591,1915.5
pyres,FALSE,5491604,3274,682,2592,1978
north,TRUE,5491383,3106,757,2349,1931.5
porge,FALSE,5491178,3212,1084,2128,2148
proin,FALSE,5491068,3053,941,2112,1997
penis,FALSE,5490769,3217,717,2500,1967
roves,FALSE,5490458,3333,787,2546,2060
melon,TRUE,5490071,3225,723,2502,1974
razes,FALSE,5489870,3455,774,2681,2114.5
amber,TRUE,5489848,3367,766,2601,2066.5
lardy,FALSE,5489595,3181,988,2193,2084.5
mento,FALSE,5489218,3244,685,2559,1964.5
gripe,TRUE,5489139,3186,1122,2064,2154
unary,FALSE,5488961,3170,943,2227,2056.5
uncle,TRUE,5488917,3159,762,2397,1960.5
fiars,FALSE,5488870,3218,833,2385,2025.5
parly,FALSE,5488870,3157,1135,2022,2146
mased,FALSE,5488837,3251,927,2324,2089
togue,FALSE,5488829,3153,1001,2152,2077
acmes,FALSE,5488487,3329,596,2733,1962.5
ingle,FALSE,5487600,3201,774,2427,1987.5
hants,FALSE,5487293,3123,687,2436,1905
force,TRUE,5486832,3221,1154,2067,2187.5
strip,TRUE,5486544,3115,820,2295,1967.5
comte,FALSE,5486511,3142,1101,2041,2121.5
overt,TRUE,5485973,3382,638,2744,2010
infer,TRUE,5485749,3297,676,2621,1986.5
karos,FALSE,5485564,3239,655,2584,1947
retax,FALSE,5485540,3506,629,2877,2067.5
holey,FALSE,5485320,3173,1142,2031,2157.5
proem,FALSE,5485266,3210,1013,2197,2111.5
dreys,FALSE,5485168,3298,594,2704,1946
shorn,TRUE,5484860,3057,1036,2021,2046.5
abode,TRUE,5484807,3275,894,2381,2084.5
comet,TRUE,5484577,3142,1109,2033,2125.5
aimed,FALSE,5484525,3280,840,2440,2060
spain,FALSE,5484313,3070,1022,2048,2046
sherd,FALSE,5484241,3260,957,2303,2108.5
louts,FALSE,5484080,3063,707,2356,1885
runts,FALSE,5483643,3129,605,2524,1867
farls,FALSE,5483580,3219,801,2418,2010
lyard,FALSE,5483484,3181,688,2493,1934.5
colts,FALSE,5483462,3054,764,2290,1909
dirge,TRUE,5483429,3210,976,2234,2093
boats,FALSE,5483244,3134,934,2200,2034
carom,FALSE,5483134,3165,839,2326,2002
rebut,TRUE,5483038,3284,739,2545,2011.5
lowse,FALSE,5482985,3189,988,2201,2088.5
servo,FALSE,5482626,3333,875,2458,2104
leare,FALSE,5482525,3450,1213,2237,2331.5
feist,FALSE,5482187,3195,1068,2127,2131.5
dhole,FALSE,5482145,3126,1085,2041,2105.5
prion,FALSE,5481888,3053,937,2116,1995
karts,FALSE,5481694,3233,662,2571,1947.5
cytes,FALSE,5481262,3206,686,2520,1946
tolus,FALSE,5481192,3063,658,2405,1860.5
noahs,FALSE,5480861,3129,687,2442,1908
togas,FALSE,5480851,3167,694,2473,1930.5
dants,FALSE,5480558,3114,729,2385,1921.5
ploye,FALSE,5480227,3140,1014,2126,2077
tamis,FALSE,5480051,3139,708,2431,1923.5
skean,FALSE,5479813,3335,846,2489,2090.5
hoist,TRUE,5479809,2984,1038,1946,2011
tanhs,FALSE,5479521,3123,656,2467,1889.5
barns,FALSE,5479424,3181,858,2323,2019.5
pioye,FALSE,5479250,3139,1015,2124,2077
voile,FALSE,5479246,3173,1174,1999,2173.5
shura,FALSE,5479188,3200,891,2309,2045.5
rahui,FALSE,5479042,3229,511,2718,1870
begar,FALSE,5478919,3369,857,2512,2113
baled,FALSE,5478874,3250,1025,2225,2137.5
clits,FALSE,5478827,3028,840,2188,1934
haver,FALSE,5478516,3330,952,2378,2141
ravey,FALSE,5478500,3368,1140,2228,2254
korai,FALSE,5478250,3268,636,2632,1952
clint,FALSE,5478205,2960,1100,1860,2030
ceiba,FALSE,5477732,3327,794,2533,2060.5
yerds,FALSE,5477489,3298,516,2782,1907
ukase,FALSE,5477367,3242,945,2297,2093.5
hault,FALSE,5477300,3060,953,2107,2006.5
vires,FALSE,5477212,3307,762,2545,2034.5
carpi,FALSE,5477104,3187,726,2461,1956.5
milor,FALSE,5476901,3103,765,2338,1934
savor,TRUE,5476650,3186,1063,2123,2124.5
uptie,FALSE,5476619,3173,787,2386,1980
codes,FALSE,5476569,3165,906,2259,2035.5
stupe,FALSE,5476456,3144,1082,2062,2113
erhus,FALSE,5476256,3347,466,2881,1906.5
rhime,FALSE,5476250,3217,1007,2210,2112
valor,TRUE,5475578,3216,803,2413,2009.5
broil,TRUE,5475522,3072,998,2074,2035
nirly,FALSE,5475471,3099,928,2171,2013.5
sabed,FALSE,5475312,3220,1163,2057,2191.5
cogie,FALSE,5474949,3124,1126,1998,2125
ayins,FALSE,5474836,3141,648,2493,1894.5
wairs,FALSE,5474107,3205,841,2364,2023
inapt,FALSE,5473969,3119,731,2388,1925
inker,FALSE,5473949,3292,663,2629,1977.5
cauls,FALSE,5473822,3080,865,2215,1972.5
slorm,FALSE,5473807,3074,1005,2069,2039.5
sneak,TRUE,5473631,3335,906,2429,2120.5
lemon,TRUE,5473339,3225,653,2572,1939
capri,FALSE,5473266,3187,723,2464,1955
adobe,TRUE,5472854,3275,853,2422,2064
pulse,TRUE,5472657,3125,1035,2090,2080
copra,FALSE,5472226,3213,751,2462,1982
belts,FALSE,5472124,3256,702,2554,1979
warts,FALSE,5471915,3225,725,2500,1975
yodel,FALSE,5471855,3164,834,2330,1999
nitry,FALSE,5471713,3118,866,2252,1992
rajes,FALSE,5471654,3447,766,2681,2106.5
lapin,FALSE,5471256,3100,738,2362,1919
bride,TRUE,5470787,3177,1199,1978,2188
talcy,FALSE,5470786,3089,1081,2008,2085
dault,FALSE,5470565,3051,995,2056,2023
derny,FALSE,5470323,3230,1062,2168,2146
yince,FALSE,5469777,3118,923,2195,2020.5
abune,FALSE,5469658,3239,928,2311,2083.5
chine,FALSE,5469240,3080,1214,1866,2147
strak,FALSE,5469107,3233,882,2351,2057.5
moper,FALSE,5468247,3210,974,2236,2092
iftar,FALSE,5468156,3267,528,2739,1897.5
louis,FALSE,5467930,3043,726,2317,1884.5
chest,TRUE,5467728,3168,943,2225,2055.5
yules,FALSE,5467578,3196,658,2538,1927
selva,FALSE,5467324,3380,830,2550,2105
grots,FALSE,5467099,3095,801,2294,1948
ulema,FALSE,5467088,3368,543,2825,1955.5
dimer,FALSE,5466782,3208,904,2304,2056
verso,TRUE,5466651,3333,677,2656,2005
trogs,FALSE,5466638,3095,772,2323,1933.5
hames,FALSE,5466517,3260,788,2472,2024
segno,FALSE,5466043,3197,915,2282,2056
malts,FALSE,5466031,3140,698,2442,1919
abrin,FALSE,5465930,3210,608,2602,1909
lipas,FALSE,5465910,3168,547,2621,1857.5
diact,FALSE,5465719,3041,1025,2016,2033
letch,FALSE,5465432,3198,732,2466,1965
relax,TRUE,5464856,3487,630,2857,2058.5
nurls,FALSE,5464837,3110,584,2526,1847
hoied,FALSE,5464242,3125,1050,2075,2087.5
duras,FALSE,5464209,3191,659,2532,1925
psoai,FALSE,5464206,3193,576,2617,1884.5
coapt,FALSE,5463808,3043,1087,1956,2065
archi,FALSE,5463750,3220,503,2717,1861.5
cunei,FALSE,5463687,3158,852,2306,2005
gades,FALSE,5463410,3253,848,2405,2050.5
naped,FALSE,5463257,3231,835,2396,2033
glute,FALSE,5463204,3128,1044,2084,2086
drays,FALSE,5462949,3151,724,2427,1937.5
borde,FALSE,5462909,3203,1108,2095,2155.5
rumes,FALSE,5462867,3266,706,2560,1986
suint,FALSE,5462716,2939,1253,1686,2096
centu,FALSE,5462457,3178,719,2459,1948.5
guile,TRUE,5462249,3108,1153,1955,2130.5
shard,TRUE,5462022,3113,1087,2026,2100
koras,FALSE,5461756,3239,661,2578,1950
lycra,FALSE,5461732,3259,383,2876,1821
inlay,TRUE,5461727,3171,760,2411,1965.5
bayes,FALSE,5461656,3267,860,2407,2063.5
curst,FALSE,5461517,3027,971,2056,1999
henry,FALSE,5461469,3239,966,2273,2102.5
koine,FALSE,5461198,3128,1171,1957,2149.5
raiks,FALSE,5461071,3213,766,2447,1989.5
yamen,FALSE,5460967,3230,819,2411,2024.5
donas,FALSE,5460620,3120,728,2392,1924
carps,FALSE,5460610,3158,751,2407,1954.5
blets,FALSE,5460534,3256,726,2530,1991
sloth,TRUE,5460495,2985,1089,1896,2037
pedro,FALSE,5460451,3282,669,2613,1975.5
aboil,FALSE,5460342,3144,715,2429,1929.5
pains,FALSE,5460182,3070,930,2140,2000
dewar,FALSE,5459971,3366,754,2612,2060
blent,FALSE,5459912,3188,986,2202,2087
dames,FALSE,5459782,3251,830,2421,2040.5
floes,FALSE,5459703,3202,935,2267,2068.5
probe,TRUE,5459380,3179,1101,2078,2140
meany,FALSE,5459347,3230,1202,2028,2216
coram,FALSE,5459326,3165,845,2320,2005
nopal,FALSE,5459321,3126,693,2433,1909.5
rafts,FALSE,5459132,3238,609,2629,1923.5
rewon,FALSE,5458108,3310,635,2675,1972.5
viner,FALSE,5458031,3239,914,2325,2076.5
thiol,FALSE,5457970,3014,847,2167,1930.5
pusle,FALSE,5457960,3125,994,2131,2059.5
owlet,FALSE,5457446,3238,768,2470,2003
nidal,FALSE,5457212,3124,633,2491,1878.5
cargo,TRUE,5457098,3167,799,2368,1983
vaute,FALSE,5456632,3238,1075,2163,2156.5
amour,FALSE,5456472,3174,717,2457,1945.5
mouse,TRUE,5456436,3102,1146,1956,2124
loach,FALSE,5455868,3057,965,2092,2011
abide,TRUE,5455607,3249,916,2333,2082.5
goary,FALSE,5455599,3136,1217,1919,2176.5
syrah,FALSE,5455210,3160,854,2306,2007
lotus,FALSE,5454974,3063,596,2467,1829.5
pirls,FALSE,5454922,3096,705,2391,1900.5
coarb,FALSE,5454614,3134,947,2187,2040.5
tokes,FALSE,5454382,3216,794,2422,2005
nomes,FALSE,5454132,3195,731,2464,1963
porin,FALSE,5453990,3053,872,2181,1962.5
saheb,FALSE,5453846,3229,1008,2221,2118.5
hemal,FALSE,5453769,3290,691,2599,1990.5
logia,FALSE,5453191,3177,656,2521,1916.5
levas,FALSE,5452972,3380,578,2802,1979
scour,TRUE,5452898,3033,944,2089,1988.5
volte,FALSE,5452612,3193,997,2196,2095
mines,FALSE,5452354,3169,802,2367,1985.5
beton,FALSE,5452330,3213,788,2425,2000.5
ranch,TRUE,5452311,3123,839,2284,1981
volar,FALSE,5451770,3216,809,2407,2012.5
ample,TRUE,5451686,3257,823,2434,2040
kayle,FALSE,5451578,3232,939,2293,2085.5
yourt,FALSE,5451374,3051,855,2196,1953
ketol,FALSE,5451336,3246,661,2585,1953.5
gynae,FALSE,5451306,3232,864,2368,2048
mired,FALSE,5451111,3208,908,2300,2058
vanes,FALSE,5451031,3282,840,2442,2061
clime,FALSE,5450699,3097,1157,1940,2127
volet,FALSE,5450678,3193,1005,2188,2099
poyse,FALSE,5450607,3110,1045,2065,2077.5
plans,FALSE,5450597,3071,868,2203,1969.5
cower,TRUE,5450524,3208,1033,2175,2120.5
roshi,FALSE,5450488,3154,503,2651,1828.5
vesta,FALSE,5450312,3399,568,2831,1983.5
malis,FALSE,5449881,3120,717,2403,1918.5
pians,FALSE,5449620,3070,869,2201,1969.5
erugo,FALSE,5449174,3323,638,2685,1980.5
bream,FALSE,5448911,3367,822,2545,2094.5
storm,TRUE,5448390,3093,881,2212,1987
baits,FALSE,5447900,3108,918,2190,2013
brake,TRUE,5447605,3271,1226,2045,2248.5
preys,FALSE,5447011,3274,625,2649,1949.5
straw,TRUE,5446707,3225,786,2439,2005.5
crems,FALSE,5446683,3257,746,2511,2001.5
nidor,FALSE,5446656,3077,658,2419,1867.5
biota,FALSE,5446648,3163,822,2341,1992.5
medal,TRUE,5446390,3281,743,2538,2012
maker,TRUE,5446357,3302,953,2349,2127.5
roven,FALSE,5446110,3265,881,2384,2073
salmi,FALSE,5446098,3120,861,2259,1990.5
molas,FALSE,5446093,3146,697,2449,1921.5
mercs,FALSE,5446049,3257,700,2557,1978.5
azote,FALSE,5446030,3340,950,2390,2145
cured,FALSE,5445950,3168,983,2185,2075.5
glias,FALSE,5445730,3122,781,2341,1951.5
slove,FALSE,5445727,3144,1281,1863,2212.5
snout,TRUE,5445565,2965,1032,1933,1998.5
dyers,FALSE,5444918,3298,499,2799,1898.5
rives,FALSE,5444552,3307,710,2597,2008.5
cigar,TRUE,5444351,3141,842,2299,1991.5
stoma,FALSE,5444206,3165,819,2346,1992
parve,FALSE,5444108,3297,1079,2218,2188
tauld,FALSE,5443992,3051,898,2153,1974.5
ridge,TRUE,5443803,3210,882,2328,2046
clave,FALSE,5443791,3210,1176,2034,2193
sythe,FALSE,5443482,3137,952,2185,2044.5
verts,FALSE,5443038,3327,623,2704,1975
larks,FALSE,5443027,3214,646,2568,1930
maneh,FALSE,5442648,3192,1007,2185,2099.5
whear,FALSE,5442596,3375,779,2596,2077
pants,FALSE,5442401,3090,760,2330,1925
coned,FALSE,5442361,3097,1052,2045,2074.5
meson,FALSE,5441609,3195,691,2504,1943
lesbo,FALSE,5441158,3262,492,2770,1877
clept,FALSE,5441098,3165,879,2286,2022
rhino,TRUE,5440534,3086,755,2331,1920.5
poley,FALSE,5440428,3140,1215,1925,2177.5
belay,FALSE,5440228,3297,1054,2243,2175.5
besti,FALSE,5440156,3255,645,2610,1950
bones,FALSE,5439835,3164,945,2219,2054.5
cimar,FALSE,5439763,3139,836,2303,1987.5
orbit,TRUE,5439456,3091,776,2315,1933.5
deity,TRUE,5438799,3157,1122,2035,2139.5
aerie,FALSE,5438703,3449,1128,2321,2288.5
herds,FALSE,5438691,3260,579,2681,1919.5
bored,FALSE,5438592,3203,1051,2152,2127
blats,FALSE,5438315,3109,856,2253,1982.5
ranee,FALSE,5438292,3352,1290,2062,2321
venal,FALSE,5438283,3312,743,2569,2027.5
rewin,FALSE,5438088,3284,661,2623,1972.5
grits,FALSE,5437899,3069,823,2246,1946
scrap,TRUE,5437828,3158,788,2370,1973
trigs,FALSE,5437438,3069,794,2275,1931.5
hosey,FALSE,5436858,3143,1110,2033,2126.5
rigol,FALSE,5436589,3105,662,2443,1883.5
wager,TRUE,5436546,3296,984,2312,2140
redip,FALSE,5436185,3256,636,2620,1946
meins,FALSE,5435961,3169,833,2336,2001
tamin,FALSE,5435703,3071,802,2269,1936.5
mpret,FALSE,5435256,3204,902,2302,2053
theic,FALSE,5434870,3197,659,2538,1928
gular,FALSE,5434773,3151,788,2363,1969.5
bails,FALSE,5434240,3089,941,2148,2015
emits,FALSE,5434146,3286,551,2735,1918.5
saser,FALSE,5433824,3420,1280,2140,2350
gulet,FALSE,5433681,3128,984,2144,2056
silty,FALSE,5433678,2997,1183,1814,2090
paver,FALSE,5433624,3297,1025,2272,2161
copes,FALSE,5432772,3141,889,2252,2015
truly,TRUE,5432666,3026,1107,1919,2066.5
trims,FALSE,5432620,3067,786,2281,1926.5
azole,FALSE,5432370,3321,973,2348,2147
mayor,TRUE,5432259,3134,784,2350,1959
coden,FALSE,5432221,3097,1000,2097,2048.5
lythe,FALSE,5432000,3167,674,2493,1920.5
ponce,FALSE,5431993,3073,1136,1937,2104.5
toman,FALSE,5431915,3097,782,2315,1939.5
aulic,FALSE,5431903,3109,628,2481,1868.5
shoed,FALSE,5431878,3096,1190,1906,2143
boule,TRUE,5431776,3101,1203,1898,2152
belon,FALSE,5431646,3194,789,2405,1991.5
rakis,FALSE,5431182,3213,615,2598,1914
bento,FALSE,5430793,3213,751,2462,1982
ervil,FALSE,5430688,3337,702,2635,2019.5
cides,FALSE,5430663,3139,829,2310,1984
flies,FALSE,5430503,3176,957,2219,2066.5
based,FALSE,5430412,3220,993,2227,2106.5
tophe,FALSE,5430412,3121,938,2183,2029.5
basil,TRUE,5430264,3089,871,2218,1980
basto,FALSE,5430182,3134,754,2380,1944
larum,FALSE,5430092,3149,679,2470,1914
sugar,TRUE,5429839,3121,994,2127,2057.5
curio,TRUE,5429570,3062,763,2299,1912.5
lands,FALSE,5429466,3095,636,2459,1865.5
cavie,FALSE,5429454,3209,1133,2076,2171
float,TRUE,5429427,3104,997,2107,2050.5
lomas,FALSE,5429361,3146,627,2519,1886.5
fiest,FALSE,5429326,3195,939,2256,2067
crags,FALSE,5429282,3112,884,2228,1998
locis,FALSE,5429012,3034,617,2417,1825.5
hules,FALSE,5428780,3158,721,2437,1939.5
tango,TRUE,5428511,3099,726,2373,1912.5
guise,TRUE,5428484,3078,1162,1916,2120
suave,TRUE,5428302,3189,1329,1860,2259
tulsi,FALSE,5427533,3037,629,2408,1833
cohen,FALSE,5427520,3106,934,2172,2020
atoms,FALSE,5427134,3165,566,2599,1865.5
ferns,FALSE,5426876,3268,759,2509,2013.5
slang,TRUE,5426754,3025,1097,1928,2061
sloid,FALSE,5426627,2956,1087,1869,2021.5
capot,FALSE,5426304,3043,945,2098,1994
scaly,TRUE,5426288,3040,1239,1801,2139.5
matin,FALSE,5426217,3071,810,2261,1940.5
pages,FALSE,5426213,3229,867,2362,2048
lovie,FALSE,5426052,3173,998,2175,2085.5
morts,FALSE,5425749,3093,724,2369,1908.5
emacs,FALSE,5425272,3329,605,2724,1967
tonic,TRUE,5425070,2985,756,2229,1870.5
maned,FALSE,5424930,3183,986,2197,2084.5
avels,FALSE,5424819,3380,531,2849,1955.5
prays,FALSE,5424792,3127,755,2372,1941
manto,FALSE,5424700,3097,747,2350,1922
mural,TRUE,5424583,3149,775,2374,1962
rudas,FALSE,5424583,3191,565,2626,1878
horns,FALSE,5424498,3057,729,2328,1893
crams,FALSE,5424464,3110,876,2234,1993
balti,FALSE,5424100,3138,739,2399,1938.5
holed,FALSE,5423948,3126,896,2230,2011
macro,TRUE,5423787,3165,677,2488,1921
tabis,FALSE,5423314,3108,704,2404,1906
colin,FALSE,5422964,2966,877,2089,1921.5
cafes,FALSE,5422682,3238,881,2357,2059.5
gents,FALSE,5422452,3191,671,2520,1931
opens,FALSE,5422148,3243,497,2746,1870
dules,FALSE,5422045,3149,763,2386,1956
upset,TRUE,5421689,3144,745,2399,1944.5
axite,FALSE,5421572,3316,984,2332,2150
sigla,FALSE,5421257,3122,861,2261,1991.5
solve,TRUE,5421162,3144,1227,1917,2185.5
vaper,FALSE,5421018,3297,935,2362,2116
agios,FALSE,5421016,3147,587,2560,1867
monal,FALSE,5420994,3078,844,2234,1961
meads,FALSE,5420980,3251,761,2490,2006
carob,FALSE,5420948,3134,808,2326,1971
laich,FALSE,5420524,3031,949,2082,1990
poake,FALSE,5420485,3186,1207,1979,2196.5
stove,TRUE,5420310,3163,1157,2006,2160
gapes,FALSE,5419613,3229,831,2398,2030
along,TRUE,5418992,3080,809,2271,1944.5
clapt,FALSE,5418879,3018,1009,2009,2013.5
rumen,FALSE,5418519,3198,800,2398,1999
afros,FALSE,5417414,3244,480,2764,1862
tuned,FALSE,5417363,3100,910,2190,2005
raved,FALSE,5417128,3321,894,2427,2107.5
odyle,FALSE,5416766,3164,676,2488,1920
slive,FALSE,5416527,3118,1303,1815,2210.5
items,FALSE,5416175,3286,392,2894,1839
coble,FALSE,5416114,3092,1120,1972,2106
voars,FALSE,5416056,3186,817,2369,2001.5
craze,TRUE,5415632,3285,1216,2069,2250.5
mulie,FALSE,5415193,3106,987,2119,2046.5
arete,FALSE,5414858.5,3469,1148,2321,2308.5
nerdy,TRUE,5414348,3230,875,2355,2052.5
pyral,FALSE,5414338,3157,647,2510,1902
liang,FALSE,5414295,3054,820,2234,1937
goris,FALSE,5413871,3075,751,2324,1913
naves,FALSE,5413225,3282,744,2538,2013
calve,FALSE,5413082,3210,1084,2126,2147
yards,FALSE,5412971,3151,578,2573,1864.5
ruche,FALSE,5412870,3177,799,2378,1988
aloft,TRUE,5412481,3104,874,2230,1989
rimed,FALSE,5412129,3208,804,2404,2006
obeli,FALSE,5412037,3291,407,2884,1849
pinta,FALSE,5411949,3119,686,2433,1902.5
shope,FALSE,5411850,3072,1228,1844,2150
supra,FALSE,5411808,3167,826,2341,1996.5
segni,FALSE,5411499,3171,868,2303,2019.5
plues,FALSE,5411477,3125,862,2263,1993.5
bohea,FALSE,5411466,3284,843,2441,2063.5
goura,FALSE,5411393,3176,775,2401,1975.5
kerns,FALSE,5411330,3263,643,2620,1953
clash,TRUE,5411134,3002,1016,1986,2009
picra,FALSE,5411036,3187,616,2571,1901.5
cakes,FALSE,5410882,3233,868,2365,2050.5
glary,FALSE,5410670,3111,1139,1972,2125
hyena,TRUE,5410609,3311,515,2796,1913
twine,TRUE,5410212,3114,1065,2049,2089.5
blame,TRUE,5410187,3178,1173,2005,2175.5
sharp,TRUE,5410150,3089,1025,2064,2057
spect,FALSE,5410090,3135,1009,2126,2072
token,TRUE,5410034,3148,888,2260,2018
chape,FALSE,5409914,3138,1123,2015,2130.5
grime,TRUE,5409771,3138,1140,1998,2139
dryas,FALSE,5409743,3151,606,2545,1878.5
dices,FALSE,5409739,3139,723,2416,1931
regma,FALSE,5409389,3400,546,2854,1973
cours,FALSE,5409098,3033,830,2203,1931.5
tikes,FALSE,5408476,3190,717,2473,1953.5
botas,FALSE,5408352,3134,762,2372,1948
shaul,FALSE,5408254,3011,1055,1956,2033
mauri,FALSE,5408161,3148,739,2409,1943.5
axile,FALSE,5407912,3297,1007,2290,2152
bider,FALSE,5407713,3177,980,2197,2078.5
whale,TRUE,5407559,3186,1120,2066,2153
lokes,FALSE,5407480,3197,733,2464,1965
slype,FALSE,5407305,3085,1070,2015,2077.5
gyres,FALSE,5407137,3228,655,2573,1941.5
swelt,FALSE,5407045,3183,1002,2181,2092.5
sowne,FALSE,5407010,3091,1277,1814,2184
value,TRUE,5406842,3219,965,2254,2092
moans,FALSE,5406787,3048,911,2137,1979.5
groin,TRUE,5406601,3007,914,2093,1960.5
olive,TRUE,5406527,3173,978,2195,2075.5
rubes,FALSE,5406130,3235,702,2533,1968.5
parev,FALSE,5406086,3297,927,2370,2112
setup,TRUE,5405772,3144,857,2287,2000.5
pacey,FALSE,5405530,3176,1184,1992,2180
toady,FALSE,5405435,3036,1168,1868,2102
ludes,FALSE,5404669,3149,703,2446,1926
lyted,FALSE,5404530,3158,658,2500,1908
orval,FALSE,5404508,3216,676,2540,1946
gilas,FALSE,5404459,3122,628,2494,1875
strig,FALSE,5404149,3069,805,2264,1937
tubar,FALSE,5403934,3137,767,2370,1952
absey,FALSE,5403906,3267,919,2348,2093
shake,TRUE,5403813,3164,1296,1868,2230
sengi,FALSE,5403065,3171,834,2337,2002.5
gable,FALSE,5402955,3180,1062,2118,2121
toped,FALSE,5402942,3112,922,2190,2017
grave,TRUE,5402863,3251,1159,2092,2205
shied,TRUE,5402678,3070,1212,1858,2141
knarl,FALSE,5402539,3146,722,2424,1934
wrens,FALSE,5402474,3255,745,2510,2000
solid,TRUE,5402062,2956,1033,1923,1994.5
styed,FALSE,5401916,3128,908,2220,2018
pucer,FALSE,5401896,3144,914,2230,2029
stang,FALSE,5401337,3044,973,2071,2008.5
robed,FALSE,5401298,3203,877,2326,2040
latex,FALSE,5401108,3317,829,2488,2073
waide,FALSE,5401094,3176,1146,2030,2161
beany,FALSE,5400922,3199,1268,1931,2233.5
latch,TRUE,5400914,3051,794,2257,1922.5
strim,FALSE,5400848,3067,806,2261,1936.5
tryke,FALSE,5400775,3179,924,2255,2051.5
stoun,FALSE,5400572,2965,899,2066,1932
faces,FALSE,5400240,3238,850,2388,2044
riven,FALSE,5400204,3239,804,2435,2021.5
marly,FALSE,5400131,3109,1100,2009,2104.5
orpin,FALSE,5400040,3053,654,2399,1853.5
rupia,FALSE,5400028,3196,571,2625,1883.5
pilot,TRUE,5400012,2981,841,2140,1911
viral,TRUE,5399946,3190,727,2463,1958.5
goyle,FALSE,5399905,3094,1009,2085,2051.5
poted,FALSE,5399740,3112,968,2144,2040
krona,FALSE,5399344,3171,777,2394,1974
bagie,FALSE,5399093,3179,1126,2053,2152.5
guars,FALSE,5399059,3121,796,2325,1958.5
tholi,FALSE,5398864,3014,710,2304,1862
bluet,FALSE,5398573,3095,1110,1985,2102.5
bouse,FALSE,5398011,3071,1212,1859,2141.5
foyer,TRUE,5397496,3190,974,2216,2082
snarf,FALSE,5397145,3121,938,2183,2029.5
spray,TRUE,5396995,3127,1117,2010,2122
cavel,FALSE,5396680,3210,1025,2185,2117.5
belah,FALSE,5396574,3259,829,2430,2044
soman,FALSE,5396495,3048,999,2049,2023.5
scath,FALSE,5396294,3021,991,2030,2006
coeds,FALSE,5396112,3165,759,2406,1962
touns,FALSE,5396100,2965,811,2154,1888
gaurs,FALSE,5395939,3121,772,2349,1946.5
scuta,FALSE,5395742,3099,774,2325,1936.5
moyle,FALSE,5395633,3092,1001,2091,2046.5
lowne,FALSE,5395528,3121,999,2122,2060
crith,FALSE,5395446,2978,1009,1969,1993.5
aloud,TRUE,5395389,3057,786,2271,1921.5
feint,FALSE,5394730,3127,1079,2048,2103
taiko,FALSE,5394561,3098,832,2266,1965
kites,FALSE,5394370,3190,687,2503,1938.5
letup,FALSE,5394290,3174,579,2595,1876.5
lowes,FALSE,5394216,3189,747,2442,1968
snoke,FALSE,5394134,3099,1176,1923,2137.5
calid,FALSE,5393982,3022,890,2132,1956
bines,FALSE,5393929,3138,868,2270,2003
moray,FALSE,5393853,3134,1076,2058,2105
loury,FALSE,5393738,3032,1048,1984,2040
derig,FALSE,5393416,3210,715,2495,1962.5
spard,FALSE,5393097,3080,1004,2076,2042
sango,FALSE,5393091,3050,943,2107,1996.5
snark,FALSE,5392966,3116,1025,2091,2070.5
edict,TRUE,5392910,3188,763,2425,1975.5
sidhe,FALSE,5392883,3070,1095,1975,2082.5
image,TRUE,5392848,3210,879,2331,2044.5
atmos,FALSE,5392687,3165,447,2718,1806
orbed,FALSE,5392614,3203,801,2402,2002
viers,FALSE,5392369,3307,610,2697,1958.5
waist,TRUE,5392344,3035,1077,1958,2056
genua,FALSE,5392136,3272,642,2630,1957
posey,FALSE,5391966,3110,1183,1927,2146.5
aizle,FALSE,5391912,3295,940,2355,2117.5
slipt,FALSE,5391615,2926,1136,1790,2031
bepat,FALSE,5391158,3245,889,2356,2067
stive,FALSE,5391110,3137,1179,1958,2158
abled,TRUE,5390996,3250,705,2545,1977.5
peags,FALSE,5390824,3229,803,2426,2016
rugal,FALSE,5390189,3151,677,2474,1914
gomer,FALSE,5390064,3164,985,2179,2074.5
spina,FALSE,5390039,3070,939,2131,2004.5
krans,FALSE,5390034,3116,812,2304,1964
sonic,TRUE,5389650,2936,973,1963,1954.5
logan,FALSE,5389601,3080,727,2353,1903.5
absit,FALSE,5389376,3108,648,2460,1878
choir,TRUE,5389286,2984,956,2028,1970
files,FALSE,5389232,3176,804,2372,1990
rhyta,FALSE,5388990,3209,481,2728,1845
coins,FALSE,5388874,2936,961,1975,1948.5
haems,FALSE,5388599,3260,654,2606,1957
copen,FALSE,5388424,3073,983,2090,2028
glens,FALSE,5388349,3172,711,2461,1941.5
carbo,FALSE,5388222,3134,747,2387,1940.5
doeth,FALSE,5388190,3145,845,2300,1995
tepoy,FALSE,5388104,3159,945,2214,2052
audit,TRUE,5388045,3050,813,2237,1931.5
stylo,FALSE,5388026,3023,692,2331,1857.5
giros,FALSE,5387985,3075,648,2427,1861.5
baker,TRUE,5387932,3271,1019,2252,2145
baton,TRUE,5387812,3066,850,2216,1958
bolas,FALSE,5387668,3115,763,2352,1939
fecal,TRUE,5387492,3268,753,2515,2010.5
spode,FALSE,5387270,3063,1164,1899,2113.5
torch,TRUE,5386850,3004,882,2122,1943
doseh,FALSE,5386469,3096,927,2169,2011.5
doits,FALSE,5386239,2975,831,2144,1903
beryl,FALSE,5386194,3225,737,2488,1981
dwale,FALSE,5385761,3177,1048,2129,2112.5
rumal,FALSE,5385601,3149,671,2478,1910
nudie,FALSE,5384948,3080,880,2200,1980
wites,FALSE,5384591,3182,750,2432,1966
craft,TRUE,5384394,3068,1060,2008,2064
girts,FALSE,5384115,3069,655,2414,1862
mulse,FALSE,5383918,3077,1000,2077,2038.5
pules,FALSE,5383888,3125,794,2331,1959.5
align,TRUE,5383821,3054,814,2240,1934
miros,FALSE,5383713,3073,640,2433,1856.5
fract,FALSE,5383522,3068,1115,1953,2091.5
limas,FALSE,5383455,3120,550,2570,1835
miens,FALSE,5383100,3169,704,2465,1936.5
spilt,TRUE,5383085,2926,1108,1818,2017
fated,FALSE,5382492,3209,987,2222,2098
ephor,FALSE,5382149,3291,486,2805,1888.5
therm,FALSE,5382093,3237,664,2573,1950.5
musar,FALSE,5382039,3119,748,2371,1933.5
marcs,FALSE,5381531,3110,762,2348,1936
clays,FALSE,5381253,3040,745,2295,1892.5
tacho,FALSE,5381048,3076,595,2481,1835.5
muset,FALSE,5380947,3096,944,2152,2020
named,FALSE,5380802,3183,838,2345,2010.5
vairs,FALSE,5380712,3160,801,2359,1980.5
cedis,FALSE,5380339,3139,709,2430,1924
geyan,FALSE,5379987,3232,679,2553,1955.5
butle,FALSE,5379942,3095,1056,2039,2075.5
droke,FALSE,5379800,3138,1101,2037,2119.5
rapid,TRUE,5379742,3109,743,2366,1926
porns,FALSE,5379606,3024,802,2222,1913
decos,FALSE,5379435,3165,577,2588,1871
ralph,TRUE,5379346,3119,710,2409,1914.5
tench,FALSE,5379281,3100,821,2279,1960.5
chirt,FALSE,5379206,2978,1013,1965,1995.5
brios,FALSE,5379072,3042,874,2168,1958
poled,FALSE,5379056,3093,969,2124,2031
media,TRUE,5378362,3280,646,2634,1963
thema,FALSE,5377909,3309,602,2707,1955.5
blain,FALSE,5377817,3021,969,2052,1995
baric,FALSE,5377801,3108,829,2279,1968.5
beins,FALSE,5377536,3138,899,2239,2018.5
curli,FALSE,5377516,3037,720,2317,1878.5
posit,TRUE,5377436,2951,912,2039,1931.5
rozet,FALSE,5377148,3268,966,2302,2117
mason,TRUE,5377091,3048,753,2295,1900.5
pinas,FALSE,5376557,3070,682,2388,1876
labis,FALSE,5376412,3089,643,2446,1866
brome,FALSE,5376274,3131,1176,1955,2153.5
berth,TRUE,5376230,3206,856,2350,2031
scion,TRUE,5376084,2936,934,2002,1935
okras,FALSE,5376022,3239,413,2826,1826
gains,FALSE,5375715,3024,903,2121,1963.5
basti,FALSE,5375638,3108,707,2401,1907.5
hosed,FALSE,5375486,3096,864,2232,1980
duets,FALSE,5375304,3168,649,2519,1908.5
perog,FALSE,5375279,3212,720,2492,1966
brits,FALSE,5375202,3036,881,2155,1958.5
lengs,FALSE,5375089,3172,581,2591,1876.5
unlit,TRUE,5374793,2969,643,2326,1806
swine,TRUE,5374792,3065,1282,1783,2173.5
soken,FALSE,5374614,3099,1105,1994,2102
raspy,TRUE,5374538,3127,903,2224,2015
techs,FALSE,5374528,3168,511,2657,1839.5
chiao,FALSE,5374430,3056,829,2227,1942.5
plied,TRUE,5374421,3067,1045,2022,2056
garth,FALSE,5374409,3092,860,2232,1976
hards,FALSE,5374173,3113,641,2472,1877
frost,TRUE,5374171,3002,1071,1931,2036.5
tangi,FALSE,5373967,3073,679,2394,1876
abyes,FALSE,5373778,3267,540,2727,1903.5
rawin,FALSE,5373570,3137,723,2414,1930
gusle,FALSE,5373493,3079,967,2112,2023
lifes,FALSE,5373374,3176,669,2507,1922.5
nashi,FALSE,5373255,3103,460,2643,1781.5
adult,TRUE,5373184,3051,741,2310,1896
clons,FALSE,5373145,2937,861,2076,1899
honey,TRUE,5372951,3075,1169,1906,2122
tonga,TRUE,5372927,3099,707,2392,1903
prads,FALSE,5372503,3080,821,2259,1950.5
motey,FALSE,5372373,3111,1179,1932,2145
cions,FALSE,5372168,2936,862,2074,1899
leafy,TRUE,5371990,3237,1036,2201,2136.5
yoker,FALSE,5371804,3185,827,2358,2006
mains,FALSE,5371443,3022,895,2127,1958.5
sepic,FALSE,5371249,3115,855,2260,1985
girls,FALSE,5370455,3050,678,2372,1864
rowan,FALSE,5369782,3163,703,2460,1933
tugra,FALSE,5369361,3170,618,2552,1894
treck,FALSE,5369052,3210,858,2352,2034
tonus,FALSE,5368823,2965,685,2280,1825
chota,FALSE,5367984,3076,789,2287,1932.5
tawed,FALSE,5367788,3196,915,2281,2055.5
nerks,FALSE,5367780,3263,533,2730,1898
moues,FALSE,5367667,3102,905,2197,2003.5
quare,FALSE,5367490,3288,1092,2196,2190
haily,FALSE,5367356,3000,1165,1835,2082.5
borts,FALSE,5367324,3062,790,2272,1926
odist,FALSE,5367311,2975,751,2224,1863
rival,TRUE,5367286,3190,675,2515,1932.5
baned,FALSE,5366505,3152,1052,2100,2102
kraut,FALSE,5366424,3072,929,2143,2000.5
unces,FALSE,5366383,3129,530,2599,1829.5
bagel,TRUE,5366319,3180,1018,2162,2099
draps,FALSE,5366315,3080,771,2309,1925.5
glans,FALSE,5366130,3025,841,2184,1933
routh,FALSE,5365936,3013,827,2186,1920
scald,TRUE,5364916,2993,993,2000,1993
aitch,FALSE,5364872,3050,745,2305,1897.5
minor,TRUE,5364532,3005,792,2213,1898.5
leaky,TRUE,5364525,3232,1056,2176,2144
degas,FALSE,5364352,3253,619,2634,1936
wiles,FALSE,5363907,3163,751,2412,1957
owies,FALSE,5363480,3188,705,2483,1946.5
leuds,FALSE,5363391,3149,600,2549,1874.5
snoek,FALSE,5362822,3099,1128,1971,2113.5
spoil,TRUE,5362805,2932,985,1947,1958.5
beads,FALSE,5362555,3220,827,2393,2023.5
chaos,TRUE,5362544,3027,817,2210,1922
greys,FALSE,5362544,3228,598,2630,1913
cover,TRUE,5362316,3163,1056,2107,2109.5
cyder,FALSE,5361993,3128,826,2302,1977
duels,FALSE,5361644,3149,672,2477,1910.5
likes,FALSE,5361574,3171,656,2515,1913.5
curls,FALSE,5361022,3008,745,2263,1876.5
daily,TRUE,5360621,2991,1207,1784,2099
crabs,FALSE,5360406,3079,832,2247,1955.5
tharm,FALSE,5359874,3090,794,2296,1942
aleck,FALSE,5359783,3263,784,2479,2023.5
bents,FALSE,5359755,3158,729,2429,1943.5
caped,FALSE,5359442,3129,996,2133,2062.5
arums,FALSE,5359308,3119,677,2442,1898
koels,FALSE,5359191,3197,674,2523,1935.5
canty,FALSE,5359135,2991,1144,1847,2067.5
chats,FALSE,5358674,3021,824,2197,1922.5
algin,FALSE,5358324,3054,697,2357,1875.5
niche,TRUE,5358229,3080,747,2333,1913.5
spide,FALSE,5358070,3037,1186,1851,2111.5
chant,TRUE,5358052,2953,1084,1869,2018.5
gants,FALSE,5357934,3044,733,2311,1888.5
ngaio,FALSE,5357749,3079,572,2507,1825.5
manos,FALSE,5357532,3048,718,2330,1883
tangs,FALSE,5357473,3044,704,2340,1874
safed,FALSE,5357432,3160,1131,2029,2145.5
gonia,FALSE,5357238,3079,755,2324,1917
acold,FALSE,5357154,3048,705,2343,1876.5
surly,TRUE,5357144,2977,1241,1736,2109
taxes,FALSE,5356844,3287,819,2468,2053
yield,TRUE,5356439,3138,665,2473,1901.5
weils,FALSE,5356367,3163,789,2374,1976
amino,FALSE,5356292,3077,685,2392,1881
haunt,TRUE,5356078,2962,973,1989,1967.5
loped,FALSE,5356040,3093,861,2232,1977
diols,FALSE,5355873,2956,755,2201,1855.5
doyen,FALSE,5355647,3066,867,2199,1966.5
hawse,FALSE,5355605,3156,994,2162,2075
copal,FALSE,5355506,3024,854,2170,1939
scrag,FALSE,5355433,3112,773,2339,1942.5
felts,FALSE,5355058,3196,665,2531,1930.5
randy,TRUE,5354976,3083,981,2102,2032
noily,FALSE,5354971,2935,1108,1827,2021.5
oches,FALSE,5354674,3174,444,2730,1809
chola,FALSE,5354324,3057,812,2245,1934.5
sonly,FALSE,5353555,2906,1310,1596,2108
depot,TRUE,5353305,3112,796,2316,1954
arret,FALSE,5352853,3469,1142,2327,2305.5
sepoy,FALSE,5352684,3110,1162,1948,2136
holts,FALSE,5352680,2985,635,2350,1810
flyer,TRUE,5352567,3165,896,2269,2030.5
foals,FALSE,5352518,3055,920,2135,1987.5
scram,TRUE,5352132,3110,774,2336,1942
doula,FALSE,5351759,3057,781,2276,1919
overs,FALSE,5351713,3333,421,2912,1877
sorex,FALSE,5351624,3221,1134,2087,2177.5
godet,FALSE,5350688,3066,1040,2026,2053
nicol,FALSE,5350631,2966,583,2383,1774.5
fleur,FALSE,5350604,3205,808,2397,2006.5
naevi,FALSE,5350456,3311,575,2736,1943
comes,FALSE,5350317,3093,892,2201,1992.5
boyar,FALSE,5350026,3103,856,2247,1979.5
dauts,FALSE,5349965,3021,755,2266,1888
clout,TRUE,5349535,2893,978,1915,1935.5
arvos,FALSE,5349428,3186,625,2561,1905.5
bigae,FALSE,5349399,3179,1029,2150,2104
daunt,TRUE,5349343,2953,1015,1938,1984
louns,FALSE,5349198,2946,750,2196,1848
rebus,TRUE,5348778,3235,522,2713,1878.5
until,TRUE,5348487,2969,545,2424,1757
cagot,FALSE,5348437,2997,954,2043,1975.5
salse,FALSE,5348380.5,3231,1377,1854,2304
peach,TRUE,5348114,3138,982,2156,2060
gault,FALSE,5347941,2981,999,1982,1990
conge,FALSE,5347783,3027,1116,1911,2071.5
piety,TRUE,5347781,3133,1024,2109,2078.5
point,TRUE,5347460,2883,1122,1761,2002.5
track,TRUE,5346833,3063,988,2075,2025.5
karns,FALSE,5346812,3116,705,2411,1910.5
angst,TRUE,5346625,3044,719,2325,1881.5
ocker,FALSE,5346594,3216,623,2593,1919.5
poesy,TRUE,5346262,3110,1133,1977,2121.5
moist,TRUE,5346178,2903,1076,1827,1989.5
proul,FALSE,5346084,2961,891,2070,1926
skail,FALSE,5346018,3024,997,2027,2010.5
dolts,FALSE,5345945,2976,677,2299,1826.5
fayne,FALSE,5345902,3139,1075,2064,2107
pardi,FALSE,5345775,3109,689,2420,1899
ragus,FALSE,5345585,3121,594,2527,1857.5
argus,FALSE,5345283,3121,593,2528,1857
chals,FALSE,5345014,3002,847,2155,1924.5
frist,FALSE,5344971,2976,1093,1883,2034.5
byres,FALSE,5344440,3195,713,2482,1954
stalk,TRUE,5344323,3044,1025,2019,2034.5
paced,FALSE,5344158,3129,938,2191,2033.5
stony,TRUE,5343850,2925,1233,1692,2079
litho,FALSE,5343822,3014,487,2527,1750.5
cursi,FALSE,5343751,3007,729,2278,1868
ligan,FALSE,5343695,3054,650,2404,1852
decay,TRUE,5343669,3200,936,2264,2068
giron,FALSE,5343637,3007,742,2265,1874.5
benis,FALSE,5343605,3138,748,2390,1943
today,TRUE,5343575,3036,1030,2006,2033
sabin,FALSE,5343546,2991,1015,1976,2003
carex,FALSE,5343544,3287,991,2296,2139
glode,FALSE,5343471,3047,1053,1994,2050
breid,FALSE,5343285,3177,893,2284,2035
hauls,FALSE,5343040,3011,736,2275,1873.5
cagey,TRUE,5342947,3130,1251,1879,2190.5
tramp,TRUE,5342762,3057,847,2210,1952
tynde,FALSE,5342696,3060,804,2256,1932
chais,FALSE,5342524,3001,843,2158,1922
sohur,FALSE,5342486,2964,948,2016,1956
gnats,FALSE,5341980,3044,684,2360,1864
fient,FALSE,5341869,3127,950,2177,2038.5
flirt,TRUE,5341781,3006,1008,1998,2007
skran,FALSE,5341674,3116,832,2284,1974
proke,FALSE,5341643,3114,1132,1982,2123
clasp,TRUE,5341544,2969,933,2036,1951
padri,FALSE,5341389,3109,684,2425,1896.5
shaly,FALSE,5341136,2971,1343,1628,2157
ramus,FALSE,5340997,3119,588,2531,1853.5
celom,FALSE,5340952,3123,726,2397,1924.5
rabic,FALSE,5340507,3108,655,2453,1881.5
grays,FALSE,5340325,3081,728,2353,1904.5
split,TRUE,5340301,2926,950,1976,1938
brave,TRUE,5340166,3218,1217,2001,2217.5
zante,FALSE,5339829,3217,1009,2208,2113
homie,FALSE,5339579,3053,991,2062,2022
douce,FALSE,5339557,3004,1131,1873,2067.5
guest,TRUE,5339515,3098,902,2196,2000
kelts,FALSE,5339512,3191,549,2642,1870
thurl,FALSE,5339442,2988,766,2222,1877
duals,FALSE,5339425,3002,802,2200,1902
adust,FALSE,5339419,3021,750,2271,1885.5
spaul,FALSE,5339329,2978,972,2006,1975
embar,FALSE,5339322,3367,542,2825,1954.5
lefts,FALSE,5339200,3196,530,2666,1863
liman,FALSE,5339107,3052,644,2408,1848
souct,FALSE,5338622,2863,1215,1648,2039
caids,FALSE,5338549,2992,873,2119,1932.5
shiur,FALSE,5338546,2938,1070,1868,2004
rotch,FALSE,5338382,3004,786,2218,1895
manis,FALSE,5337512,3022,744,2278,1883
inust,FALSE,5337496,2939,710,2229,1824.5
mages,FALSE,5337474,3181,832,2349,2006.5
dogie,FALSE,5337432,3046,1039,2007,2042.5
soree,FALSE,5337411,3184,1550,1634,2367
muras,FALSE,5337313,3119,655,2464,1887
games,FALSE,5337158,3181,834,2347,2007.5
votes,FALSE,5337102,3163,787,2376,1975
warns,FALSE,5337033,3108,768,2340,1938
treat,TRUE,5336795,3469,1009,2460,2239
whore,FALSE,5336691,3139,1047,2092,2093
zoeal,FALSE,5336595,3321,778,2543,2049.5
waled,FALSE,5336483,3177,935,2242,2056
marid,FALSE,5336269,3061,850,2211,1955.5
skoal,FALSE,5336086,3050,939,2111,1994.5
coude,FALSE,5336085,3004,1135,1869,2069.5
oaked,FALSE,5335632,3210,793,2417,2001.5
sprad,FALSE,5335623,3080,871,2209,1975.5
lysed,FALSE,5335384,3109,627,2482,1868
swail,FALSE,5335346,3016,1031,1985,2023.5
loids,FALSE,5335147,2956,738,2218,1847
cornu,FALSE,5335144,2965,823,2142,1894
spake,FALSE,5334888,3131,1213,1918,2172
fatso,FALSE,5334837,3074,780,2294,1927
glost,FALSE,5334721,2906,984,1922,1945
prude,TRUE,5334695,3066,1067,1999,2066.5
omens,FALSE,5334435,3195,474,2721,1834.5
laked,FALSE,5334150,3185,840,2345,2012.5
tajes,FALSE,5334106,3277,810,2467,2043.5
spied,TRUE,5333753,3037,1129,1908,2083
monas,FALSE,5333724,3048,724,2324,1886
upran,FALSE,5333707,3099,550,2549,1824.5
pirns,FALSE,5333700,2998,725,2273,1861.5
obeah,FALSE,5333653,3284,536,2748,1910
styli,FALSE,5333482,2997,645,2352,1821
crony,TRUE,5333418,2925,1255,1670,2090
hayed,FALSE,5333400,3131,838,2293,1984.5
baurs,FALSE,5333242,3088,830,2258,1959
piled,FALSE,5333150,3067,892,2175,1979.5
cobra,TRUE,5333034,3134,750,2384,1942
sawed,FALSE,5332368,3147,1132,2015,2139.5
plots,FALSE,5332353,2952,762,2190,1857
harim,FALSE,5332332,3070,736,2334,1903
chirl,FALSE,5332216,2959,916,2043,1937.5
graip,FALSE,5331891,3039,903,2136,1971
kyrie,FALSE,5331872,3159,788,2371,1973.5
obias,FALSE,5331702,3114,522,2592,1818
board,TRUE,5331530,3056,1029,2027,2042.5
mylar,FALSE,5331517,3109,617,2492,1863
twyer,FALSE,5330964,3171,752,2419,1961.5
hurst,FALSE,5330735,2958,842,2116,1900
nouls,FALSE,5330655,2946,679,2267,1812.5
posed,FALSE,5330594,3063,937,2126,2000
flota,FALSE,5330559,3104,784,2320,1944
mange,TRUE,5330352,3113,1050,2063,2081.5
faint,TRUE,5330212,2980,1141,1839,2060.5
indue,FALSE,5330172,3080,702,2378,1891
gyral,FALSE,5329871,3111,620,2491,1865.5
harps,FALSE,5329828,3089,622,2467,1855.5
hyles,FALSE,5329796,3118,558,2560,1838
welts,FALSE,5329733,3183,612,2571,1897.5
fried,TRUE,5329404,3117,1105,2012,2111
pards,FALSE,5329281,3080,714,2366,1897
clads,FALSE,5328964,2993,811,2182,1902
drupe,FALSE,5328507,3066,1017,2049,2041.5
buteo,FALSE,5328446,3120,846,2274,1983
sixer,FALSE,5328424,3195,1110,2085,2152.5
sudor,FALSE,5328329,2955,971,1984,1963
cluey,FALSE,5328211,3026,1246,1780,2136
poney,FALSE,5328059,3042,1242,1800,2142
unled,FALSE,5327951,3081,668,2413,1874.5
cyano,FALSE,5327774,2997,768,2229,1882.5
glues,FALSE,5327010,3079,835,2244,1957
daisy,TRUE,5326856,2961,1216,1745,2088.5
platy,FALSE,5326539,2987,1153,1834,2070
fouet,FALSE,5326436,3060,1151,1909,2105.5
symar,FALSE,5326267,3079,825,2254,1952
nipas,FALSE,5326145,3070,496,2574,1783
longa,FALSE,5326025,3080,646,2434,1863
pelma,FALSE,5325822,3257,628,2629,1942.5
soapy,TRUE,5325670,2963,1366,1597,2164.5
bulse,FALSE,5325493,3046,1066,1980,2056
biros,FALSE,5325288,3042,706,2336,1874
toged,FALSE,5325075,3066,931,2135,1998.5
menad,FALSE,5324912,3183,769,2414,1976
audio,TRUE,5324823,3056,618,2438,1837
howre,FALSE,5324646,3139,950,2189,2044.5
skort,FALSE,5324630,2997,1025,1972,2011
smolt,FALSE,5324572,2904,1063,1841,1983.5
holme,FALSE,5324552,3054,952,2102,2003
durst,FALSE,5324000,2949,884,2065,1916.5
sizer,FALSE,5323902,3193,1109,2084,2151
iches,FALSE,5323734,3148,437,2711,1792.5
elvan,FALSE,5323051,3312,615,2697,1963.5
soldi,FALSE,5322829,2956,837,2119,1896.5
fones,FALSE,5322769,3104,908,2196,2006
phone,TRUE,5322766,3004,1136,1868,2070
marsh,TRUE,5322712,3041,884,2157,1962.5
amnio,FALSE,5322361,3077,534,2543,1805.5
micra,FALSE,5322297,3139,581,2558,1860
tilak,FALSE,5322267,3073,739,2334,1906
siped,FALSE,5321616,3037,1062,1975,2049.5
croak,TRUE,5321469,3069,985,2084,2027
cutey,FALSE,5321306,3045,1177,1868,2111
flats,FALSE,5321249,3049,819,2230,1934
noisy,TRUE,5321206,2905,1117,1788,2011
braid,TRUE,5321066,3030,1023,2007,2026.5
rinds,FALSE,5321028,3022,551,2471,1786.5
noyed,FALSE,5321015,3066,781,2285,1923.5
lawed,FALSE,5320886,3177,854,2323,2015.5
chute,TRUE,5320866,3007,1070,1937,2038.5
tendu,FALSE,5320750,3100,600,2500,1850
alcid,FALSE,5320617,3022,674,2348,1848
fiats,FALSE,5320272,3048,820,2228,1934
zonae,FALSE,5319891,3223,1008,2215,2115.5
wrist,TRUE,5319646,2963,1040,1923,2001.5
loafs,FALSE,5319430,3055,745,2310,1900
defat,FALSE,5319407,3209,794,2415,2001.5
often,TRUE,5319396,3153,608,2545,1880.5
ngati,FALSE,5319355,3073,506,2567,1789.5
screw,TRUE,5319333,3153,904,2249,2028.5
extra,TRUE,5319232,3506,413,3093,1959.5
clerk,TRUE,5319155,3191,841,2350,2016
bason,FALSE,5318666,3017,819,2198,1918
weald,FALSE,5318381,3177,912,2265,2044.5
tyned,FALSE,5318379,3060,747,2313,1903.5
admen,FALSE,5318053,3183,670,2513,1926.5
tryma,FALSE,5317232,3128,577,2551,1852.5
liken,TRUE,5317226,3103,750,2353,1926.5
carbs,FALSE,5317184,3079,725,2354,1902
fails,FALSE,5317174,3029,904,2125,1966.5
anglo,FALSE,5317168,3080,515,2565,1797.5
yours,FALSE,5317114,3002,638,2364,1820
binal,FALSE,5316663,3021,833,2188,1927
sinew,TRUE,5316614,3065,1042,2023,2053.5
voles,FALSE,5316418,3144,788,2356,1966
doric,FALSE,5316140,2975,742,2233,1858.5
nutso,FALSE,5316094,2965,563,2402,1764
chiro,FALSE,5315984,2984,818,2166,1901
axone,FALSE,5315890,3225,1005,2220,2115
mutes,FALSE,5315833,3096,758,2338,1927
cadis,FALSE,5315821,2992,771,2221,1881.5
icker,FALSE,5315654,3190,616,2574,1903
topis,FALSE,5315524,2951,680,2271,1815.5
deman,FALSE,5315416,3183,707,2476,1945
knars,FALSE,5315269,3116,602,2514,1859
herms,FALSE,5314978,3188,578,2610,1883
metic,FALSE,5314728,3116,649,2467,1882.5
foule,FALSE,5314710,3041,1166,1875,2103.5
felon,TRUE,5314580,3134,752,2382,1943
sadly,TRUE,5314433,2962,1271,1691,2116.5
glide,TRUE,5314271,3021,1075,1946,2048
dregs,FALSE,5313984,3181,667,2514,1924
tease,TRUE,5313404,3250,1293,1957,2271.5
begat,TRUE,5313291,3199,898,2301,2048.5
scalp,TRUE,5313044,2969,931,2038,1950
dower,FALSE,5313007,3130,946,2184,2038
fuero,FALSE,5312553,3230,709,2521,1969.5
amble,TRUE,5312494,3178,822,2356,2000
codas,FALSE,5312033,3018,751,2267,1884.5
pesty,FALSE,5311886,3104,967,2137,2035.5
galut,FALSE,5311811,2981,866,2115,1923.5
vlies,FALSE,5311783,3118,864,2254,1991
worst,TRUE,5311768,2989,949,2040,1969
honed,FALSE,5311579,3028,923,2105,1975.5
sayid,FALSE,5311514,2961,975,1986,1968
agons,FALSE,5311464,3050,615,2435,1832.5
arett,FALSE,5311455,3469,977,2492,2223
broad,TRUE,5311134,3056,965,2091,2010.5
skyre,FALSE,5311120,3130,981,2149,2055.5
moted,FALSE,5311001,3064,933,2131,1998.5
exalt,TRUE,5310734,3317,808,2509,2062.5
crawl,TRUE,5310727,3036,953,2083,1994.5
shlep,FALSE,5310512,3047,996,2051,2021.5
oxter,FALSE,5310292,3270,696,2574,1983
tachs,FALSE,5310010,3021,573,2448,1797
laxes,FALSE,5309942,3268,758,2510,2013
linty,FALSE,5309827,2929,932,1997,1930.5
dunes,FALSE,5309676,3051,790,2261,1920.5
caves,FALSE,5309410,3180,905,2275,2042.5
goety,FALSE,5309220,3113,1074,2039,2093.5
sears,FALSE,5309220,3420,1103,2317,2261.5
types,FALSE,5308790,3104,584,2520,1844
ontic,FALSE,5308742,2985,428,2557,1706.5
cadge,FALSE,5308661,3083,1077,2006,2080
grout,TRUE,5308607,2934,961,1973,1947.5
ranks,FALSE,5308408,3116,639,2477,1877.5
derms,FALSE,5308243,3179,620,2559,1899.5
polts,FALSE,5307788,2952,708,2244,1830
birls,FALSE,5307758,3017,736,2281,1876.5
brash,TRUE,5307509,3010,1057,1953,2033.5
meous,FALSE,5307291,3102,711,2391,1906.5
hilts,FALSE,5306774,2959,558,2401,1758.5
lathy,FALSE,5306732,3020,895,2125,1957.5
tepid,TRUE,5306712,3086,725,2361,1905.5
skyer,FALSE,5306216,3130,935,2195,2032.5
loves,FALSE,5306008,3144,770,2374,1957
savey,FALSE,5305532,3149,1401,1748,2275
waits,FALSE,5305509,3035,828,2207,1931.5
ephas,FALSE,5305435,3308,341,2967,1824.5
lazes,FALSE,5305420,3266,757,2509,2011.5
lodge,TRUE,5305259,3047,942,2105,1994.5
rebid,FALSE,5305068,3177,680,2497,1928.5
huias,FALSE,5304538,3010,720,2290,1865
syker,FALSE,5304386,3130,931,2199,2030.5
hutia,FALSE,5304170,3059,588,2471,1823.5
opted,FALSE,5304143,3112,649,2463,1880.5
wried,FALSE,5304079,3104,1052,2052,2078
avens,FALSE,5303597,3282,551,2731,1916.5
wiels,FALSE,5303506,3163,660,2503,1911.5
chias,FALSE,5303392,3001,807,2194,1904
narks,FALSE,5303262,3116,595,2521,1855.5
mosey,FALSE,5303227,3062,1148,1914,2105
grins,FALSE,5303017,2952,866,2086,1909
patly,FALSE,5302854,2987,1083,1904,2035
styme,FALSE,5302520,3056,964,2092,2010
azure,TRUE,5302172,3294,884,2410,2089
hopes,FALSE,5301990,3072,760,2312,1916
kails,FALSE,5301628,3024,788,2236,1906
softa,FALSE,5301618,3074,873,2201,1973.5
tarre,FALSE,5301154,3469,1192,2277,2330.5
lurve,FALSE,5300900,3147,907,2240,2027
grasp,TRUE,5300616,3010,916,2094,1963
torsk,FALSE,5300404,2997,875,2122,1936
signa,FALSE,5300035,3024,881,2143,1952.5
hides,FALSE,5299881,3070,700,2370,1885
breys,FALSE,5299847,3195,656,2539,1925.5
urbia,FALSE,5299752,3117,579,2538,1848
model,TRUE,5299426,3045,935,2110,1990
gules,FALSE,5299421,3079,767,2312,1923
lunts,FALSE,5299193,2940,588,2352,1764
rawns,FALSE,5299186,3108,653,2455,1880.5
cymae,FALSE,5299091,3128,869,2259,1998.5
uneth,FALSE,5298928,3109,575,2534,1842
lauds,FALSE,5298873,3002,662,2340,1832
basin,TRUE,5298646,2991,845,2146,1918
tater,FALSE,5298494,3469,1094,2375,2281.5
chain,TRUE,5298176,2933,937,1996,1935
pauls,FALSE,5298148,2978,809,2169,1893.5
cloke,FALSE,5298104,3027,1122,1905,2074.5
shmoe,FALSE,5298035,3024,1127,1897,2075.5
lewis,FALSE,5297986,3163,550,2613,1856.5
dynel,FALSE,5297962,3041,747,2294,1894
zeals,FALSE,5297902,3266,750,2516,2008
mince,TRUE,5297348,2999,1024,1975,2011.5
aunty,TRUE,5297099,3000,969,2031,1984.5
units,FALSE,5296977,2939,561,2378,1750
dirke,FALSE,5296816,3112,955,2157,2033.5
gryce,FALSE,5296649,3058,987,2071,2022.5
inkle,FALSE,5296595,3103,719,2384,1911
etyma,FALSE,5296556,3347,310,3037,1828.5
shave,TRUE,5296374,3111,1287,1824,2199
corny,TRUE,5296340,2925,1186,1739,2055.5
liefs,FALSE,5295743,3176,538,2638,1857
heady,TRUE,5295671,3131,1051,2080,2091
skirt,TRUE,5295430,2971,1047,1924,2009
dopes,FALSE,5295255,3063,802,2261,1932.5
bants,FALSE,5295237,3011,791,2220,1901
mules,FALSE,5295149,3077,759,2318,1918
peony,FALSE,5294960,3042,1174,1868,2108
yipes,FALSE,5294882,3084,620,2464,1852
houri,FALSE,5294810,2993,676,2317,1834.5
mohel,FALSE,5294725,3054,869,2185,1961.5
pical,FALSE,5294316,2998,719,2279,1858.5
melic,FALSE,5294044,3097,650,2447,1873.5
dorty,FALSE,5293705,2964,1056,1908,2010
octad,FALSE,5293684,3067,473,2594,1770
takis,FALSE,5293634,3043,659,2384,1851
jeats,FALSE,5293582,3277,744,2533,2010.5
erase,TRUE,5293127,3420,1241,2179,2330.5
flame,TRUE,5293121,3118,1136,1982,2127
urman,FALSE,5292899,3051,654,2397,1852.5
gleam,TRUE,5292395,3211,698,2513,1954.5
hasty,TRUE,5292260,2990,956,2034,1973
capos,FALSE,5292044,2994,728,2266,1861
wails,FALSE,5291849,3016,851,2165,1933.5
drags,FALSE,5291765,3034,797,2237,1915.5
coupe,TRUE,5291740,2980,1116,1864,2048
polis,FALSE,5291638,2932,727,2205,1829.5
siree,FALSE,5291505,3158,1473,1685,2315.5
first,TRUE,5291187,2976,925,2051,1950.5
morns,FALSE,5290867,2976,767,2209,1871.5
sakti,FALSE,5290858,3043,832,2211,1937.5
pulao,FALSE,5290390,3033,661,2372,1847
umras,FALSE,5290342,3119,433,2686,1776
moled,FALSE,5290317,3045,934,2111,1989.5
miaul,FALSE,5290281,2959,854,2105,1906.5
unarm,FALSE,5290021,3051,621,2430,1836
scrab,FALSE,5289946,3079,743,2336,1911
folia,FALSE,5289844,3084,749,2335,1916.5
ached,FALSE,5289726,3162,626,2536,1894
nomas,FALSE,5289596,3048,576,2472,1812
knelt,TRUE,5289490,3123,699,2424,1911
ferly,FALSE,5289158,3165,1067,2098,2116
limey,FALSE,5289051,3066,1033,2033,2049.5
richt,FALSE,5288930,2978,644,2334,1811
rusty,TRUE,5288610,2996,874,2122,1935
payed,FALSE,5288508,3098,911,2187,2004.5
erick,FALSE,5288461,3190,870,2320,2030
poker,TRUE,5288114,3114,963,2151,2038.5
grads,FALSE,5288036,3034,794,2240,1914
hadst,FALSE,5288024,2943,872,2071,1907.5
drily,FALSE,5287923,2919,1170,1749,2044.5
ethic,TRUE,5287873,3197,347,2850,1772
minas,FALSE,5287818,3022,647,2375,1834.5
pinot,FALSE,5287643,2883,868,2015,1875.5
giber,FALSE,5287421,3107,904,2203,2005.5
scout,TRUE,5287270,2863,985,1878,1924
claim,TRUE,5287123,2950,906,2044,1928
hiker,FALSE,5287100,3121,813,2308,1967
goaty,FALSE,5287001,2966,1204,1762,2085
drams,FALSE,5286947,3032,789,2243,1910.5
front,TRUE,5286714,2934,1082,1852,2008
lidos,FALSE,5286533,2956,533,2423,1744.5
vealy,FALSE,5286358,3179,1118,2061,2148.5
twals,FALSE,5285986,3036,698,2338,1867
tapus,FALSE,5285904,2997,629,2368,1813
waney,FALSE,5285486,3126,1208,1918,2167
ravin,FALSE,5285362,3092,746,2346,1919
prief,FALSE,5285310,3093,1019,2074,2056
amins,FALSE,5285254,3022,663,2359,1842.5
decry,TRUE,5285223,3128,925,2203,2026.5
kebar,FALSE,5284982,3271,694,2577,1982.5
bonce,FALSE,5284829,2994,1167,1827,2080.5
claps,FALSE,5284619,2969,792,2177,1880.5
treyf,FALSE,5284531,3184,622,2562,1903
fades,FALSE,5283647,3160,869,2291,2014.5
flute,TRUE,5283441,3035,1065,1970,2050
talks,FALSE,5283229,3044,656,2388,1850
luges,FALSE,5283005,3079,695,2384,1887
syned,FALSE,5282959,3011,964,2047,1987.5
mache,FALSE,5282889,3090,919,2171,2004.5
lyric,TRUE,5282773,2997,463,2534,1730
pyran,FALSE,5282720,3059,621,2438,1840
patus,FALSE,5282702,2997,675,2322,1836
yurts,FALSE,5282698,2996,530,2466,1763
stond,FALSE,5282478,2878,987,1891,1932.5
halve,TRUE,5282300,3141,955,2186,2048
piney,TRUE,5282153,3016,1165,1851,2090.5
spurt,TRUE,5282087,2925,997,1928,1961
azine,FALSE,5281948,3197,1015,2182,2106
lurid,TRUE,5281800,2959,713,2246,1836
canid,FALSE,5281613,2924,917,2007,1920.5
caged,FALSE,5281575,3083,1005,2078,2044
pargo,FALSE,5281424,3065,743,2322,1904
egads,FALSE,5281293,3253,496,2757,1874.5
udals,FALSE,5281262,3002,558,2444,1780
dicta,FALSE,5280595,3041,572,2469,1806.5
diker,FALSE,5280365,3112,855,2257,1983.5
linga,FALSE,5280119,3054,569,2485,1811.5
hakes,FALSE,5280100,3164,739,2425,1951.5
rivas,FALSE,5280016,3160,555,2605,1857.5
arene,FALSE,5279976.5,3352,1191,2161,2271.5
powre,FALSE,5279754,3106,1023,2083,2064.5
duper,FALSE,5279663,3066,885,2181,1975.5
katis,FALSE,5279528,3043,629,2414,1836
miaou,FALSE,5279497,2984,749,2235,1866.5
buras,FALSE,5278888,3088,721,2367,1904.5
crisp,TRUE,5278431,2896,958,1938,1927
hours,FALSE,5278316,2964,701,2263,1832.5
cuber,FALSE,5277988,3065,971,2094,2018
oleum,FALSE,5277802,3132,543,2589,1837.5
sperm,TRUE,5277748,3155,798,2357,1976.5
brays,FALSE,5277628,3048,786,2262,1917
cloam,FALSE,5277191,2976,848,2128,1912
wheat,TRUE,5276968,3205,820,2385,2012.5
rybat,FALSE,5276870,3097,601,2496,1849
fines,FALSE,5276863,3078,831,2247,1954.5
pacos,FALSE,5276760,2994,670,2324,1832
dulia,FALSE,5276751,3031,631,2400,1831
laiks,FALSE,5276621,3024,749,2275,1886.5
bodle,FALSE,5276265,3014,1113,1901,2063.5
mabes,FALSE,5276149,3148,822,2326,1985
dobie,FALSE,5276107,3013,1029,1984,2021
diram,FALSE,5275903,3061,681,2380,1871
lunge,TRUE,5275883,3011,913,2098,1962
laund,FALSE,5275868,2934,857,2077,1895.5
lovat,FALSE,5275732,3046,832,2214,1939
fired,FALSE,5275620,3117,937,2180,2027
power,TRUE,5274850,3106,977,2129,2041.5
timed,FALSE,5274581,3038,848,2190,1943
golpe,FALSE,5274561,3023,980,2043,2001.5
plica,FALSE,5274389,2998,825,2173,1911.5
syboe,FALSE,5274242,3031,1002,2029,2016.5
reify,FALSE,5274114,3164,1012,2152,2088
break,TRUE,5273976,3271,893,2378,2082
lomed,FALSE,5273585,3045,864,2181,1954.5
stork,TRUE,5273455,2997,952,2045,1974.5
chuse,FALSE,5273441,2958,1102,1856,2030
rebop,FALSE,5273216,3179,592,2587,1885.5
twirl,TRUE,5273188,2993,767,2226,1880
comal,FALSE,5273051,2976,857,2119,1916.5
pacts,FALSE,5272890,2988,677,2311,1832.5
liths,FALSE,5272784,2959,465,2494,1712
yourn,FALSE,5272766,2934,732,2202,1833
tegus,FALSE,5272555,3098,576,2522,1837
drove,TRUE,5272361,3085,1092,1993,2088.5
heids,FALSE,5272285,3070,682,2388,1876
ahold,FALSE,5272002,2979,809,2170,1894
roked,FALSE,5271618,3138,832,2306,1985
melty,FALSE,5271609,3086,964,2122,2025
ovine,TRUE,5271462,3075,928,2147,2001.5
prems,FALSE,5271009,3155,690,2465,1922.5
faker,FALSE,5270866,3211,982,2229,2096.5
acyls,FALSE,5270442,3040,408,2632,1724
pured,FALSE,5270276,3066,927,2139,1996.5
perms,FALSE,5270086,3155,651,2504,1903
icons,FALSE,5269940,2936,536,2400,1736
threw,TRUE,5269601,3133,791,2342,1962
robin,TRUE,5269532,2974,729,2245,1851.5
amend,TRUE,5269487,3183,656,2527,1919.5
patsy,TRUE,5269089,2957,1092,1865,2024.5
taxor,FALSE,5269022,3123,809,2314,1966
pilau,FALSE,5268790,3007,620,2387,1813.5
tubes,FALSE,5268582,3065,746,2319,1905.5
ebons,FALSE,5268350,3164,550,2614,1857
chary,FALSE,5268332,2990,1165,1825,2077.5
meith,FALSE,5268249,3047,893,2154,1970
unica,FALSE,5268213,3011,602,2409,1806.5
kades,FALSE,5268101,3155,753,2402,1954
potin,FALSE,5267974,2883,820,2063,1851.5
lanch,FALSE,5267861,2934,822,2112,1878
geoid,FALSE,5267853,3046,877,2169,1961.5
crepy,FALSE,5267111,3104,1056,2048,2080
dulce,FALSE,5267039,2979,985,1994,1982
bursa,FALSE,5266855,3088,757,2331,1922.5
clued,TRUE,5266839,2979,1000,1979,1989.5
scrod,FALSE,5266526,2946,819,2127,1882.5
lease,TRUE,5266502,3231,1232,1999,2231.5
scend,FALSE,5265913,3042,883,2159,1962.5
goeth,FALSE,5265566,3075,849,2226,1962
wider,TRUE,5265322,3104,890,2214,1997
telae,FALSE,5265253,3280,1090,2190,2185
sewin,FALSE,5265120,3065,922,2143,1993.5
idols,FALSE,5265076,2956,496,2460,1726
grand,TRUE,5265031,2966,989,1977,1977.5
nudes,FALSE,5264904,3051,652,2399,1851.5
pebas,FALSE,5264870,3196,640,2556,1918
blues,FALSE,5264313,3046,893,2153,1969.5
hulas,FALSE,5264244,3011,566,2445,1788.5
urped,FALSE,5263926,3066,794,2272,1930
yuans,FALSE,5263736,2951,717,2234,1834
halid,FALSE,5263200,2953,761,2192,1857
veils,FALSE,5262972,3118,749,2369,1933.5
yonis,FALSE,5262959,2905,618,2287,1761.5
ajies,FALSE,5262596,3257,763,2494,2010
unget,FALSE,5262386,3030,758,2272,1894
retox,FALSE,5262366,3270,598,2672,1934
trayf,FALSE,5262312,3037,752,2285,1894.5
kines,FALSE,5261317,3073,715,2358,1894
natch,FALSE,5261149,2953,743,2210,1848
lubra,FALSE,5261134,3118,547,2571,1832.5
trows,FALSE,5260813,2989,721,2268,1855
seiza,FALSE,5260246,3265,958,2307,2111.5
lives,FALSE,5260102,3118,693,2425,1905.5
lepid,FALSE,5259810,3067,664,2403,1865.5
moits,FALSE,5259343,2903,827,2076,1865
kalis,FALSE,5258844,3024,630,2394,1827
lweis,FALSE,5258813,3163,503,2660,1833
yulan,FALSE,5258694,2981,597,2384,1789
fasti,FALSE,5258572,3048,670,2378,1859
elchi,FALSE,5258547,3178,368,2810,1773
rowed,FALSE,5258354,3130,846,2284,1988
wades,FALSE,5258322,3147,816,2331,1981.5
frits,FALSE,5258136,2976,844,2132,1910
rubai,FALSE,5258088,3117,522,2595,1819.5
cords,FALSE,5257973,2946,745,2201,1845.5
unmet,TRUE,5257798,3028,752,2276,1890
daube,FALSE,5257779,3059,1028,2031,2043.5
plesh,FALSE,5257679,3047,830,2217,1938.5
airer,FALSE,5257646,3449,1036,2413,2242.5
butes,FALSE,5257408,3065,824,2241,1944.5
wafer,TRUE,5257341,3203,942,2261,2072.5
leavy,FALSE,5257086,3179,1047,2132,2113
texas,FALSE,5256826,3287,602,2685,1944.5
cyans,FALSE,5256736,2942,746,2196,1844
noyau,FALSE,5256655,3006,509,2497,1757.5
zoner,FALSE,5256541,3151,951,2200,2051
omrah,FALSE,5255628,3096,544,2552,1820
tiyns,FALSE,5255626,2899,598,2301,1748.5
porty,FALSE,5255548,2940,1087,1853,2013.5
maced,FALSE,5255419,3081,903,2178,1992
kolas,FALSE,5255056,3050,610,2440,1830
daynt,FALSE,5254775,2913,879,2034,1896
rusma,FALSE,5254084,3119,503,2616,1811
calps,FALSE,5253910,2969,700,2269,1834.5
twice,TRUE,5253894,3012,1035,1977,2023.5
novel,TRUE,5253513,3076,839,2237,1957.5
bardo,FALSE,5253155,3056,767,2289,1911.5
tripy,FALSE,5253048,2914,1096,1818,2005
horsy,FALSE,5253015,2924,1046,1878,1985
kerma,FALSE,5252746,3302,557,2745,1929.5
fiery,TRUE,5252149,3164,1031,2133,2097.5
thesp,FALSE,5251766,3066,697,2369,1881.5
kaneh,FALSE,5251611,3096,920,2176,2008
wines,FALSE,5251538,3065,778,2287,1921.5
heapy,FALSE,5251326,3107,1032,2075,2069.5
refly,FALSE,5251050,3165,898,2267,2031.5
herbs,FALSE,5250920,3157,534,2623,1845.5
demit,FALSE,5250830,3038,825,2213,1931.5
crops,FALSE,5250706,2922,795,2127,1858.5
sowce,FALSE,5250692,2989,1247,1742,2118
setae,FALSE,5250517,3250,1306,1944,2278
harms,FALSE,5250460,3041,640,2401,1840.5
wired,FALSE,5250295,3104,884,2220,1994
forts,FALSE,5250258,3002,753,2249,1877.5
tronk,FALSE,5250025,2929,955,1974,1942
ursid,FALSE,5250004,2929,656,2273,1792.5
yirth,FALSE,5249678,2947,649,2298,1798
darcy,FALSE,5249487,2981,1094,1887,2037.5
zoeas,FALSE,5249325,3291,658,2633,1974.5
takin,FALSE,5249286,2975,753,2222,1864
rater,FALSE,5249260,3469,1050,2419,2259.5
girns,FALSE,5249233,2952,698,2254,1825
fural,FALSE,5249092,3058,804,2254,1931
walis,FALSE,5249065,3016,693,2323,1854.5
alifs,FALSE,5249021,3029,679,2350,1854
plaid,TRUE,5249017,2920,926,1994,1923
prams,FALSE,5248790,3008,820,2188,1914
teuch,FALSE,5248688,3007,847,2160,1927
dargs,FALSE,5248543,3034,690,2344,1862
slank,FALSE,5248518,2927,1169,1758,2048
skirl,FALSE,5248440,2952,950,2002,1951
palsy,TRUE,5248405,2938,1093,1845,2015.5
dirty,TRUE,5247799,2938,979,1959,1958.5
fraus,FALSE,5247710,3028,828,2200,1928
capon,FALSE,5247696,2926,822,2104,1874
atopy,FALSE,5247562,3012,876,2136,1944
breds,FALSE,5247558,3148,722,2426,1935
dropt,FALSE,5247449,2893,925,1968,1909
pasty,TRUE,5247368,2957,1029,1928,1993
runic,FALSE,5247138,2939,619,2320,1779
slurp,TRUE,5247047,2906,940,1966,1923
draft,TRUE,5246877,2990,973,2017,1981.5
ileum,FALSE,5246862,3106,536,2570,1821
cardy,FALSE,5246015,2981,1098,1883,2039.5
tondi,FALSE,5245880,2907,647,2260,1777
moils,FALSE,5245683,2884,850,2034,1867
crews,FALSE,5245676,3153,703,2450,1928
mesic,FALSE,5245582,3067,618,2449,1842.5
waker,FALSE,5245541,3198,929,2269,2063.5
atoks,FALSE,5245339,3069,553,2516,1811
prosy,FALSE,5245201,2891,1188,1703,2039.5
axles,FALSE,5245084,3268,621,2647,1944.5
crapy,FALSE,5244892,2957,1186,1771,2071.5
tulpa,FALSE,5244366,3027,561,2466,1794
stirk,FALSE,5244255,2971,974,1997,1972.5
saved,FALSE,5244160,3102,1155,1947,2128.5
tikas,FALSE,5243940,3043,562,2481,1802.5
hurts,FALSE,5243900,2958,593,2365,1775.5
scand,FALSE,5243694,2895,1013,1882,1954
drive,TRUE,5243161,3059,1114,1945,2086.5
blist,FALSE,5242824,2847,1064,1783,1955.5
awols,FALSE,5242804,3042,627,2415,1834.5
lipos,FALSE,5242736,2932,516,2416,1724
fents,FALSE,5242689,3098,692,2406,1895
lordy,FALSE,5242613,2945,963,1982,1954
piker,FALSE,5242208,3088,886,2202,1987
hoyas,FALSE,5242194,2996,576,2420,1786
piton,FALSE,5242088,2883,717,2166,1800
bidet,FALSE,5242085,3007,1021,1986,2014
mosed,FALSE,5241855,3015,902,2113,1958.5
sputa,FALSE,5241665,2997,795,2202,1896
duros,FALSE,5241035,2955,628,2327,1791.5
swage,FALSE,5240916,3077,1217,1860,2147
rabid,TRUE,5240550,3030,742,2288,1886
fairy,TRUE,5240492,3017,1222,1795,2119.5
brins,FALSE,5240320,2919,924,1995,1921.5
count,TRUE,5239878,2795,1077,1718,1936
curns,FALSE,5239800,2910,765,2145,1837.5
ombre,TRUE,5239388,3131,712,2419,1921.5
money,TRUE,5239320,2994,1207,1787,2100.5
twain,FALSE,5239148,2967,788,2179,1877.5
scarf,TRUE,5238850,3019,891,2128,1955
scapi,FALSE,5238848,2968,774,2194,1871
beams,FALSE,5238842,3148,826,2322,1987
prunt,FALSE,5238488,2857,1009,1848,1933
pyets,FALSE,5238163,3104,517,2587,1810.5
norms,FALSE,5238075,2976,583,2393,1779.5
sitka,FALSE,5238041,3043,798,2245,1920.5
gaily,TRUE,5237997,2921,1211,1710,2066
swirl,TRUE,5237768,2944,984,1960,1964
abord,FALSE,5237508,3056,671,2385,1863.5
tumor,TRUE,5237497,2932,740,2192,1836
unapt,FALSE,5237029,2929,730,2199,1829.5
flors,FALSE,5236721,2983,769,2214,1876
zetas,FALSE,5236670,3285,555,2730,1920
nabis,FALSE,5236647,2991,592,2399,1791.5
skein,FALSE,5236619,3073,841,2232,1957
echos,FALSE,5236338,3174,289,2885,1731.5
urban,TRUE,5236162,3020,650,2370,1835
rangy,FALSE,5236081,3013,988,2025,2000.5
ichor,FALSE,5235912,2984,427,2557,1705.5
cheap,TRUE,5235753,3138,738,2400,1938
plash,FALSE,5235460,2900,960,1940,1930
loamy,TRUE,5234820,2945,1106,1839,2025.5
buran,FALSE,5234540,3020,815,2205,1917.5
omber,FALSE,5234484,3131,666,2465,1898.5
sirup,FALSE,5234382,2905,869,2036,1887
sheaf,FALSE,5234363,3169,876,2293,2022.5
prove,TRUE,5234204,3061,1123,1938,2092
shrew,TRUE,5234181,3084,1008,2076,2046
lumen,TRUE,5234069,3009,783,2226,1896
ikats,FALSE,5233958,3043,526,2517,1784.5
spica,FALSE,5233721,2968,909,2059,1938.5
nifes,FALSE,5233609,3078,618,2460,1848
pours,FALSE,5233424,2931,774,2157,1852.5
roose,FALSE,5233119,3184,1223,1961,2203.5
speld,FALSE,5233058,3038,884,2154,1961
turds,FALSE,5232975,2949,603,2346,1776
writs,FALSE,5232811,2963,791,2172,1877
laved,FALSE,5232678,3132,877,2255,2004.5
clegs,FALSE,5232288,3070,688,2382,1879
perch,TRUE,5232194,3066,838,2228,1952
irked,FALSE,5231994,3112,749,2363,1930.5
thins,FALSE,5231948,2861,777,2084,1819
ethyl,FALSE,5231748,3167,317,2850,1742
alkos,FALSE,5231687,3050,522,2528,1786
scopa,FALSE,5231664,2994,764,2230,1879
hover,TRUE,5231534,3094,927,2167,2010.5
typal,FALSE,5231524,2987,549,2438,1768
kenos,FALSE,5231013,3099,569,2530,1834
hazer,FALSE,5230946,3216,914,2302,2065
flary,FALSE,5230907,3018,1160,1858,2089
about,TRUE,5230730,2973,736,2237,1854.5
epics,FALSE,5230659,3115,587,2528,1851
owsen,FALSE,5230376,3091,613,2478,1852
hurls,FALSE,5230240,2939,616,2323,1777.5
rasse,FALSE,5230215.5,3420,1084,2336,2252
wheal,FALSE,5229978,3186,723,2463,1954.5
zlote,FALSE,5229781,3079,1011,2068,2045
acids,FALSE,5229737,2992,552,2440,1772
uveal,FALSE,5229549,3219,544,2675,1881.5
malic,FALSE,5229526,2950,712,2238,1831
prima,FALSE,5228900,3037,807,2230,1922
grike,FALSE,5227976,3042,1127,1915,2084.5
limed,FALSE,5227679,3019,787,2232,1903
clems,FALSE,5227470,3068,680,2388,1874
kents,FALSE,5227143,3093,576,2517,1834.5
forge,TRUE,5226948,3073,1078,1995,2075.5
gaunt,TRUE,5226719,2883,1019,1864,1951
fenis,FALSE,5226539,3078,711,2367,1894.5
yelps,FALSE,5226444,3085,446,2639,1765.5
ihram,FALSE,5226040,3070,546,2524,1808
grued,FALSE,5225911,3020,983,2037,2001.5
tozie,FALSE,5225384,3078,1021,2057,2049.5
brads,FALSE,5225339,3001,852,2149,1926.5
infra,FALSE,5225315,3150,362,2788,1756
trugo,FALSE,5225220,2934,715,2219,1824.5
maneb,FALSE,5225176,3080,879,2201,1979.5
worts,FALSE,5224933,2989,700,2289,1844.5
dover,FALSE,5224799,3085,969,2116,2027
unlay,FALSE,5224787,2981,759,2222,1870
toing,FALSE,5224777,2837,917,1920,1877
runty,FALSE,5224703,2928,933,1995,1930.5
tousy,FALSE,5224617,2832,1128,1704,1980
bices,FALSE,5224418,3036,785,2251,1910.5
dazer,FALSE,5224211,3207,956,2251,2081.5
waned,FALSE,5224114,3079,962,2117,2020.5
podal,FALSE,5223629,2946,815,2131,1880.5
motis,FALSE,5223583,2903,691,2212,1797
strow,FALSE,5223533,2989,755,2234,1872
craws,FALSE,5223457,3006,833,2173,1919.5
disme,FALSE,5223449,2989,885,2104,1937
visne,FALSE,5223362,3020,931,2089,1975.5
fable,TRUE,5223192,3087,1083,2004,2085
deaws,FALSE,5223156,3147,721,2426,1934
stank,TRUE,5223101,2946,1045,1901,1995.5
mauts,FALSE,5223069,2949,751,2198,1850
vertu,FALSE,5222902,3166,588,2578,1877
drabs,FALSE,5222889,3001,745,2256,1873
adopt,TRUE,5222766,2965,708,2257,1836.5
farci,FALSE,5222534,3048,766,2282,1907
forme,FALSE,5222130,3071,1070,2001,2070.5
hauns,FALSE,5221818,2913,756,2157,1834.5
lubes,FALSE,5221680,3046,685,2361,1865.5
wiper,FALSE,5221525,3080,873,2207,1976.5
crips,FALSE,5221506,2896,817,2079,1856.5
gytes,FALSE,5221121,3058,603,2455,1830.5
uncia,FALSE,5221089,3011,398,2613,1704.5
pined,FALSE,5220781,2969,919,2050,1944
pinto,TRUE,5220551,2883,680,2203,1781.5
barny,FALSE,5220484,2980,1186,1794,2083
abhor,TRUE,5220312,3065,510,2555,1787.5
foyle,FALSE,5220142,3001,1030,1971,2015.5
pagri,FALSE,5219725,3039,676,2363,1857.5
samek,FALSE,5219546,3083,1162,1921,2122.5
homes,FALSE,5219535,3024,763,2261,1893.5
pulas,FALSE,5219352,2978,639,2339,1808.5
molts,FALSE,5219049,2904,673,2231,1788.5
incur,TRUE,5218879,2939,471,2468,1705
glits,FALSE,5218686,2880,757,2123,1818.5
foray,TRUE,5218362,3043,1105,1938,2074
weird,TRUE,5218313,3104,861,2243,1982.5
dript,FALSE,5218249,2867,947,1920,1907
duans,FALSE,5218203,2904,822,2082,1863
glint,TRUE,5218064,2812,1017,1795,1914.5
ainee,FALSE,5217800,3162,1224,1938,2193
doges,FALSE,5217388,3017,811,2206,1914
wents,FALSE,5217364,3085,639,2446,1862
coyed,FALSE,5217200,2964,942,2022,1953
kauri,FALSE,5217124,3052,652,2400,1852
lobed,FALSE,5216848,3014,860,2154,1937
koura,FALSE,5216084,3078,680,2398,1879
pyats,FALSE,5215944,2957,647,2310,1802
liven,FALSE,5215754,3050,787,2263,1918.5
dawen,FALSE,5215753,3079,889,2190,1984
koans,FALSE,5215750,2952,824,2128,1888
aptly,TRUE,5215639,2987,839,2148,1913
gofer,FALSE,5215447,3073,949,2124,2011
mayst,FALSE,5215336,2909,864,2045,1886.5
clous,FALSE,5215275,2844,761,2083,1802.5
prang,FALSE,5215231,2942,939,2003,1940.5
third,TRUE,5215116,2900,829,2071,1864.5
phial,FALSE,5214988,2929,871,2058,1900
unhat,FALSE,5214813,2962,545,2417,1753.5
aumil,FALSE,5214803,2959,702,2257,1830.5
vital,TRUE,5213930,3020,675,2345,1847.5
voila,TRUE,5213908,3026,814,2212,1920
corps,FALSE,5213628,2922,726,2196,1824
round,TRUE,5213336,2887,849,2038,1868
warty,TRUE,5212975,3024,1053,1971,2038.5
domes,FALSE,5212800,3015,805,2210,1910
crank,TRUE,5212669,2946,1067,1879,2006.5
fresh,TRUE,5212662,3097,890,2207,1993.5
chyle,FALSE,5212638,2948,957,1991,1952.5
wrath,TRUE,5212543,2986,935,2051,1960.5
elogy,FALSE,5212439,3094,957,2137,2025.5
modes,FALSE,5212156,3015,815,2200,1915
staph,FALSE,5211670,2919,939,1980,1929
inorb,FALSE,5211649,2974,528,2446,1751
salvo,TRUE,5211408,2997,886,2111,1941.5
stupa,FALSE,5211118,2997,722,2275,1859.5
spald,FALSE,5210839,2891,1014,1877,1952.5
dynes,FALSE,5210692,3011,627,2384,1819
ulnad,FALSE,5210078,2934,654,2280,1794
clags,FALSE,5210069,2923,818,2105,1870.5
bruit,FALSE,5210056,2875,1016,1859,1945.5
levis,FALSE,5209778,3118,573,2545,1845.5
kaons,FALSE,5209606,2952,786,2166,1869
camos,FALSE,5209589,2946,731,2215,1838.5
mauls,FALSE,5209409,2930,774,2156,1852
neifs,FALSE,5208839,3078,616,2462,1847
vleis,FALSE,5208598,3118,615,2503,1866.5
huger,FALSE,5208531,3029,852,2177,1940.5
eater,TRUE,5208281,3469,1017,2452,2243
cuits,FALSE,5208276,2837,825,2012,1831
gynie,FALSE,5208112,2970,859,2111,1914.5
invar,FALSE,5207941,3092,545,2547,1818.5
ghest,FALSE,5207587,3020,860,2160,1940
flirs,FALSE,5207521,2957,791,2166,1874
dhals,FALSE,5207497,2924,760,2164,1842
malty,FALSE,5207091,2939,1026,1913,1982.5
picas,FALSE,5207046,2968,599,2369,1783.5
chard,TRUE,5206960,2943,919,2024,1931
sapid,FALSE,5206774,2890,1004,1886,1947
sanko,FALSE,5206478,2952,922,2030,1937
panic,TRUE,5205896,2900,774,2126,1837
plays,FALSE,5205579,2938,689,2249,1813.5
cloth,TRUE,5205433,2815,921,1894,1868
clams,FALSE,5205251,2921,810,2111,1865.5
agued,FALSE,5205158,3092,754,2338,1923
pedis,FALSE,5204665,3037,653,2384,1845
cupel,FALSE,5204562,2955,916,2039,1935.5
peaks,FALSE,5204211,3131,782,2349,1956.5
china,TRUE,5203902,2933,854,2079,1893.5
swain,FALSE,5203728,2918,1005,1913,1961.5
lysin,FALSE,5203618,2880,479,2401,1679.5
recks,FALSE,5203415,3161,494,2667,1827.5
syver,FALSE,5202914,3077,968,2109,2022.5
lakin,FALSE,5202384,2956,692,2264,1824
brand,TRUE,5202334,2933,1047,1886,1990
monde,FALSE,5202265,2947,1018,1929,1982.5
unbar,FALSE,5202153,3020,552,2468,1786
rings,FALSE,5202133,2952,558,2394,1755
shout,TRUE,5202118,2794,1089,1705,1941.5
leuch,FALSE,5201786,2988,786,2202,1887
voice,TRUE,5201706,2973,1164,1809,2068.5
sprag,FALSE,5201356,3010,794,2216,1902
hinau,FALSE,5201313,2942,574,2368,1758
chode,FALSE,5201133,2926,1079,1847,2002.5
beach,TRUE,5200950,3059,1013,2046,2036
grief,TRUE,5200843,3047,992,2055,2019.5
eikon,FALSE,5200372,3128,548,2580,1838
mayed,FALSE,5199769,3050,876,2174,1963
final,TRUE,5199597,2961,796,2165,1878.5
zeros,FALSE,5199512,3219,576,2643,1897.5
carks,FALSE,5199447,3014,756,2258,1885
buyer,TRUE,5199082,3034,918,2116,1976
spyal,FALSE,5198975,2938,775,2163,1856.5
quate,FALSE,5198892,3118,1079,2039,2098.5
vails,FALSE,5198454,2971,811,2160,1891
kasme,FALSE,5198404,3083,896,2187,1989.5
gelid,FALSE,5198359,3021,745,2276,1883
cogue,FALSE,5198347,2934,1050,1884,1992
oupas,FALSE,5197818,3003,484,2519,1743.5
terse,TRUE,5197484,3178,1149,2029,2163.5
viola,TRUE,5197202,3026,715,2311,1870.5
thrid,FALSE,5196774,2900,732,2168,1816
covet,TRUE,5196688,2993,1097,1896,2045
pions,FALSE,5196494,2834,806,2028,1820
deshi,FALSE,5196441,3070,472,2598,1771
rewth,FALSE,5195992,3133,651,2482,1892
fains,FALSE,5195952,2931,924,2007,1927.5
uhlan,FALSE,5195932,2943,582,2361,1762.5
drony,FALSE,5195901,2847,1168,1679,2007.5
sarky,FALSE,5195569,2983,1252,1731,2117.5
dobra,FALSE,5195517,3056,663,2393,1859.5
ponts,FALSE,5195419,2854,735,2119,1794.5
dorba,FALSE,5195121,3056,641,2415,1848.5
scrip,FALSE,5194634,2896,783,2113,1839.5
broke,TRUE,5194479,3035,1163,1872,2099
hints,FALSE,5194405,2861,585,2276,1723
naked,FALSE,5194385,3087,789,2298,1938
nacho,FALSE,5194381,2959,483,2476,1721
debit,TRUE,5194093,3007,821,2186,1914
hovea,FALSE,5194082,3166,779,2387,1972.5
grebo,FALSE,5193522,3133,641,2492,1887
metho,FALSE,5193235,3073,546,2527,1809.5
elfin,TRUE,5193129,3108,586,2522,1847
south,TRUE,5192968,2794,1088,1706,1941
ogled,FALSE,5192756,3047,601,2446,1824
thorp,FALSE,5192444,2902,745,2157,1823.5
deism,FALSE,5192434,2989,832,2157,1910.5
saucy,TRUE,5192404,2849,1351,1498,2100
meynt,FALSE,5192397,2988,813,2175,1900.5
asdic,FALSE,5192296,2992,421,2571,1706.5
roups,FALSE,5191996,2931,635,2296,1783
dinos,FALSE,5191540,2858,620,2238,1739
tubal,TRUE,5191316,2948,711,2237,1829.5
fecit,FALSE,5191288,3025,845,2180,1935
waurs,FALSE,5190851,3015,740,2275,1877.5
clove,TRUE,5190665,2974,1113,1861,2043.5
louma,FALSE,5190614,2985,664,2321,1824.5
glime,FALSE,5190558,2949,1074,1875,2011.5
splay,FALSE,5190295,2938,1066,1872,2002
oktas,FALSE,5190006,3069,361,2708,1715
camis,FALSE,5189569,2920,757,2163,1838.5
diyas,FALSE,5189553,2961,541,2420,1751
lawin,FALSE,5189120,2948,706,2242,1827
flyte,FALSE,5188873,2995,929,2066,1962
turps,FALSE,5188630,2925,584,2341,1754.5
vials,FALSE,5187892,2971,750,2221,1860.5
guiro,FALSE,5187771,2914,777,2137,1845.5
dints,FALSE,5187670,2852,627,2225,1739.5
ruths,FALSE,5187660,2958,466,2492,1712
helps,FALSE,5187646,3047,509,2538,1778
hyper,TRUE,5187414,3035,680,2355,1857.5
asked,FALSE,5187400,3155,605,2550,1880
cleft,TRUE,5187400,3026,864,2162,1945
volta,FALSE,5187274,3046,637,2409,1841.5
boils,FALSE,5187258,2853,916,1937,1884.5
alate,FALSE,5187216,3280,1212,2068,2246
mercy,TRUE,5187109,3056,1028,2028,2042
rowts,FALSE,5187086,2989,585,2404,1787
wersh,FALSE,5186414,3084,798,2286,1941
flans,FALSE,5186367,2932,862,2070,1897
tonka,FALSE,5186314,3001,686,2315,1843.5
indol,FALSE,5186290,2888,484,2404,1686
mower,TRUE,5186111,3058,942,2116,2000
urged,FALSE,5186059,3020,803,2217,1911.5
biled,FALSE,5185986,2988,923,2065,1955.5
genic,FALSE,5185947,3001,685,2316,1843
comas,FALSE,5185781,2946,737,2209,1841.5
janes,FALSE,5185655,3160,817,2343,1988.5
hiver,FALSE,5185628,3068,850,2218,1959
germs,FALSE,5185619,3109,624,2485,1866.5
poult,FALSE,5185426,2791,1001,1790,1896
ghast,FALSE,5185368,2873,990,1883,1931.5
purls,FALSE,5185348,2906,689,2217,1797.5
lowan,FALSE,5185332,2974,686,2288,1830
vraic,FALSE,5185237,2990,806,2184,1898
quale,FALSE,5185232,3099,1102,1997,2100.5
franc,FALSE,5185225,2951,923,2028,1937
blots,FALSE,5185189,2873,793,2080,1833
axels,FALSE,5184683,3268,530,2738,1899
culti,FALSE,5184476,2867,646,2221,1756.5
larky,FALSE,5184087,3013,974,2039,1993.5
spado,FALSE,5183660,2916,861,2055,1888.5
biont,FALSE,5183590,2804,1054,1750,1929
tinds,FALSE,5183480,2852,595,2257,1723.5
belga,FALSE,5183476,3180,667,2513,1923.5
panty,FALSE,5183461,2889,1088,1801,1988.5
puris,FALSE,5182858,2905,685,2220,1795
coxae,FALSE,5182618,3123,1076,2047,2099.5
preif,FALSE,5182125,3093,770,2323,1931.5
bards,FALSE,5182117,3001,745,2256,1873
fanos,FALSE,5182041,2957,747,2210,1852
sandy,TRUE,5182008,2864,1242,1622,2053
kurta,FALSE,5181668,3072,572,2500,1822
mured,FALSE,5181537,3018,892,2126,1955
rudis,FALSE,5181389,2929,560,2369,1744.5
rolfs,FALSE,5181260,2983,567,2416,1775
boney,TRUE,5180895,2963,1273,1690,2118
stagy,FALSE,5180774,2911,1190,1721,2050.5
shend,FALSE,5180761,2973,987,1986,1980
omega,TRUE,5180669,3236,396,2840,1816
kains,FALSE,5180406,2926,808,2118,1867
retie,FALSE,5180291,3207,1040,2167,2123.5
raser,FALSE,5180114,3420,1019,2401,2219.5
leear,FALSE,5179817.5,3450,882,2568,2166
hogen,FALSE,5179775,2958,863,2095,1910.5
darbs,FALSE,5179667,3001,638,2363,1819.5
lymes,FALSE,5179433,3037,526,2511,1781.5
ugali,FALSE,5179062,2961,525,2436,1743
cyber,TRUE,5179004,3025,808,2217,1916.5
diver,TRUE,5178893,3059,892,2167,1975.5
brust,FALSE,5178781,2846,1029,1817,1937.5
yowie,FALSE,5178696,2987,893,2094,1940
haves,FALSE,5178628,3111,776,2335,1943.5
trier,FALSE,5178342,3207,1212,1995,2209.5
lousy,TRUE,5177715,2813,1067,1746,1940
rykes,FALSE,5177466,3130,494,2636,1812
gilts,FALSE,5177415,2880,604,2276,1742
nixer,FALSE,5177177,3127,781,2346,1954
meiny,FALSE,5177021,2968,1161,1807,2064.5
milos,FALSE,5177013,2884,589,2295,1736.5
ylike,FALSE,5176920,2970,952,2018,1961
choil,FALSE,5176668,2795,900,1895,1847.5
unsay,FALSE,5176325,2951,727,2224,1839
foley,FALSE,5176198,3001,1209,1792,2105
crogs,FALSE,5176156,2876,821,2055,1848.5
dahls,FALSE,5176093,2924,622,2302,1773
obied,FALSE,5175926,3013,759,2254,1886
slaes,FALSE,5175773,3231,1228,2003,2229.5
witan,FALSE,5175707,2967,689,2278,1828
purge,TRUE,5175698,2996,991,2005,1993.5
blurt,TRUE,5175591,2876,944,1932,1910
oshac,FALSE,5175425,3027,260,2767,1643.5
karsy,FALSE,5175329,2983,1022,1961,2002.5
thaim,FALSE,5175126,2900,800,2100,1850
stilb,FALSE,5174746,2847,882,1965,1864.5
pomes,FALSE,5174643,2991,836,2155,1913.5
calms,FALSE,5174542,2921,718,2203,1819.5
bemas,FALSE,5174443,3148,675,2473,1911.5
newts,FALSE,5174371,3085,480,2605,1782.5
raxed,FALSE,5174080,3209,857,2352,2033
cunit,FALSE,5173723,2769,934,1835,1851.5
perdu,FALSE,5173663,3066,617,2449,1841.5
groma,FALSE,5173633,3017,758,2259,1887.5
malus,FALSE,5173279,2930,641,2289,1785.5
drawl,TRUE,5173210,2958,866,2092,1912
milts,FALSE,5173143,2878,596,2282,1737
melba,FALSE,5173025,3178,549,2629,1863.5
wrapt,FALSE,5172863,2953,960,1993,1956.5
pynes,FALSE,5172535,2987,658,2329,1822.5
cutis,FALSE,5172516,2837,689,2148,1763
livor,FALSE,5172280,2954,683,2271,1818.5
spiry,FALSE,5172143,2865,1209,1656,2037
yerks,FALSE,5171981,3130,502,2628,1816
chide,TRUE,5171933,2900,1101,1799,2000.5
clang,TRUE,5171692,2855,929,1926,1892
hinge,TRUE,5171095,2932,910,2022,1921
tanks,FALSE,5170860,2946,683,2263,1814.5
foist,TRUE,5170687,2812,1105,1707,1958.5
wains,FALSE,5170627,2918,871,2047,1894.5
roved,FALSE,5170146,3085,869,2216,1977
razed,FALSE,5169558,3207,856,2351,2031.5
ovels,FALSE,5169455,3144,431,2713,1787.5
angry,TRUE,5169448,3013,811,2202,1912
faver,FALSE,5169394,3158,1019,2139,2088.5
gobar,FALSE,5168791,2986,826,2160,1906
mopes,FALSE,5168359,2991,798,2193,1894.5
atomy,FALSE,5168194,2964,894,2070,1929
fault,TRUE,5168178,2888,1020,1868,1954
cults,FALSE,5167982,2838,671,2167,1754.5
ferny,FALSE,5167936,3067,1087,1980,2077
buats,FALSE,5167764,2918,841,2077,1879.5
parch,FALSE,5167676,2919,900,2019,1909.5
tigon,FALSE,5167423,2837,680,2157,1758.5
dimes,FALSE,5166894,2989,728,2261,1858.5
guano,FALSE,5166617,2889,848,2041,1868.5
rifts,FALSE,5166244,2976,507,2469,1741.5
nicad,FALSE,5166223,2924,576,2348,1750
sates,FALSE,5165748,3250,1135,2115,2192.5
gleba,FALSE,5165707,3180,581,2599,1880.5
nazes,FALSE,5165655,3168,706,2462,1937
horny,TRUE,5165558,2856,1057,1799,1956.5
levin,FALSE,5165430,3050,667,2383,1858.5
hylas,FALSE,5165260,2971,403,2568,1687
sprew,FALSE,5165256,3051,925,2126,1988
mavie,FALSE,5165041,3059,1042,2017,2050.5
vades,FALSE,5164927,3102,776,2326,1939
omits,FALSE,5164772,2903,520,2383,1711.5
pheon,FALSE,5164741,3004,725,2279,1864.5
bialy,FALSE,5164738,2888,1208,1680,2048
sixte,FALSE,5164730,3025,1143,1882,2084
dinge,FALSE,5164360,2923,952,1971,1937.5
grams,FALSE,5164323,2962,793,2169,1877.5
cokes,FALSE,5163900,2997,843,2154,1920
genty,FALSE,5163512,2990,999,1991,1994.5
timon,FALSE,5162835,2835,674,2161,1754.5
kants,FALSE,5162625,2946,638,2308,1792
croze,FALSE,5162506,3049,1153,1896,2101
fouat,FALSE,5161900,2913,996,1917,1954.5
rawly,FALSE,5161468,3005,961,2044,1983
speak,TRUE,5161259,3131,880,2251,2005.5
amity,TRUE,5161196,2938,948,1990,1943
laigh,FALSE,5160640,2883,873,2010,1878
bolts,FALSE,5160624,2873,739,2134,1806
frays,FALSE,5160562,2988,749,2239,1868.5
limos,FALSE,5160281,2884,519,2365,1701.5
phage,FALSE,5159690,2990,1093,1897,2041.5
relie,FALSE,5159607,3188,1041,2147,2114.5
sizar,FALSE,5159366,3046,954,2092,2000
yokel,FALSE,5159186,2996,771,2225,1883.5
rowme,FALSE,5158958,3058,902,2156,1980
jeans,FALSE,5158700,3160,787,2373,1973.5
masty,FALSE,5158629,2909,994,1915,1951.5
shand,FALSE,5158542,2826,1117,1709,1971.5
fusel,FALSE,5158466,2986,876,2110,1931
bytes,FALSE,5158424,3025,661,2364,1843
vines,FALSE,5158143,3020,738,2282,1879
pluot,FALSE,5158027,2791,893,1898,1842
donah,FALSE,5158026,2881,831,2050,1856
apish,FALSE,5157830,2899,778,2121,1838.5
aviso,FALSE,5157547,2996,651,2345,1823.5
glory,TRUE,5157544,2875,1076,1799,1975.5
fames,FALSE,5157395,3088,855,2233,1971.5
ramps,FALSE,5157215,3008,556,2452,1782
golem,TRUE,5157021,2975,866,2109,1920.5
freak,TRUE,5156910,3211,856,2355,2033.5
vired,FALSE,5156900,3059,844,2215,1951.5
betid,FALSE,5156346,3007,802,2205,1904.5
dicot,FALSE,5156289,2805,754,2051,1779.5
chafe,TRUE,5156216,2999,1108,1891,2053.5
ulpan,FALSE,5156141,2910,585,2325,1747.5
biome,TRUE,5156084,2941,1111,1830,2026
dobes,FALSE,5156063,2984,801,2183,1892.5
blits,FALSE,5155989,2847,815,2032,1831
niefs,FALSE,5155978,3078,487,2591,1782.5
yapon,FALSE,5155712,2895,630,2265,1762.5
globe,TRUE,5155700,2944,1008,1936,1976
valis,FALSE,5155670,2971,653,2318,1812
gryde,FALSE,5155660,2980,904,2076,1942
japer,FALSE,5155642,3175,912,2263,2043.5
podia,FALSE,5155601,2945,718,2227,1831.5
corgi,FALSE,5155572,2905,727,2178,1816
prahu,FALSE,5155520,2928,745,2183,1836.5
graze,TRUE,5155491,3137,1133,2004,2135
tempo,TRUE,5155223,3040,560,2480,1800
scraw,FALSE,5154797,3006,749,2257,1877.5
dunce,TRUE,5154670,2881,1012,1869,1946.5
bogle,FALSE,5154601,2944,1105,1839,2024.5
rakus,FALSE,5154580,3023,539,2484,1781
whole,TRUE,5154433,2950,1057,1893,2003.5
trugs,FALSE,5154182,2879,693,2186,1786
grunt,TRUE,5154021,2811,982,1829,1896.5
knaur,FALSE,5153807,2955,708,2247,1831.5
bodes,FALSE,5153731,2984,881,2103,1932.5
cauld,FALSE,5153510,2832,947,1885,1889.5
demoi,FALSE,5153084,3044,557,2487,1800.5
wants,FALSE,5152846,2938,701,2237,1819.5
coyau,FALSE,5152840,2904,670,2234,1787
frons,FALSE,5152454,2885,865,2020,1875
locus,TRUE,5152410,2844,541,2303,1692.5
clype,FALSE,5152243,2915,902,2013,1908.5
bogie,FALSE,5152111,2943,1101,1842,2022
cakey,FALSE,5151942,3032,1196,1836,2114
reata,FALSE,5151780,3469,857,2612,2163
moble,FALSE,5151701,2942,1029,1913,1985.5
piend,FALSE,5151527,2969,821,2148,1895
psion,FALSE,5150990,2834,686,2148,1760
dicey,TRUE,5150799,2938,1051,1887,1994.5
civet,FALSE,5150782,2967,1020,1947,1993.5
aguti,FALSE,5150384,2980,468,2512,1724
lirks,FALSE,5150139,2952,544,2408,1748
cnida,FALSE,5150042,2924,684,2240,1804
grove,TRUE,5149737,3015,1096,1919,2055.5
shark,TRUE,5149519,2945,1082,1863,2013.5
pints,FALSE,5149513,2828,658,2170,1743
mobie,FALSE,5149211,2941,1025,1916,1983
sauch,FALSE,5148750,2811,1126,1685,1968.5
sdayn,FALSE,5148554,2864,826,2038,1845
aspic,FALSE,5148499,2968,404,2564,1686
dowar,FALSE,5148471,2983,791,2192,1887
sulci,FALSE,5148338,2818,827,1991,1822.5
cobia,FALSE,5148286,2944,756,2188,1850
gemot,FALSE,5148226,2994,803,2191,1898.5
stong,FALSE,5148211,2808,910,1898,1859
manul,FALSE,5148180,2862,788,2074,1825
hyens,FALSE,5148173,3020,487,2533,1753.5
flues,FALSE,5147247,2986,856,2130,1921
ovals,FALSE,5147236,2997,561,2436,1779
yelms,FALSE,5147076,3037,464,2573,1750.5
eupad,FALSE,5146880,3138,597,2541,1867.5
tabus,FALSE,5146712,2918,628,2290,1773
makes,FALSE,5146469,3083,777,2306,1930
paths,FALSE,5146418,2919,621,2298,1770
login,TRUE,5146407,2818,722,2096,1770
hamed,FALSE,5146205,3012,870,2142,1941
orgic,FALSE,5146166,2905,564,2341,1734.5
fitna,FALSE,5145890,2980,695,2285,1837.5
awned,FALSE,5145869,3079,760,2319,1919.5
baith,FALSE,5145306,2869,1021,1848,1945
kyloe,FALSE,5145192,2996,711,2285,1853.5
sales,FALSE,5145064,3231,1136,2095,2183.5
krays,FALSE,5145016,2983,633,2350,1808
thrip,FALSE,5144902,2876,670,2206,1773
femal,FALSE,5144647,3118,758,2360,1938
sling,TRUE,5144428,2763,1056,1707,1909.5
naifs,FALSE,5144321,2931,678,2253,1804.5
waver,TRUE,5144069,3145,966,2179,2055.5
macon,FALSE,5143673,2878,729,2149,1803.5
merch,FALSE,5143455,3018,803,2215,1910.5
gleys,FALSE,5143331,3039,532,2507,1785.5
emics,FALSE,5142946,3067,564,2503,1815.5
skyte,FALSE,5142522,2960,968,1992,1964
uveas,FALSE,5142279,3189,424,2765,1806.5
enoki,FALSE,5142228,3128,469,2659,1798.5
shalm,FALSE,5142196,2852,1021,1831,1936.5
crims,FALSE,5142138,2848,835,2013,1841.5
kames,FALSE,5141849,3083,739,2344,1911
veins,FALSE,5141750,3020,769,2251,1894.5
bayed,FALSE,5141344,3019,942,2077,1980.5
seats,FALSE,5140622,3250,1090,2160,2170
luach,FALSE,5140388,2841,872,1969,1856.5
duces,FALSE,5140165,2949,707,2242,1828
padis,FALSE,5140147,2890,715,2175,1802.5
alums,FALSE,5140095,2930,611,2319,1770.5
ancho,FALSE,5140049,2959,370,2589,1664.5
demur,TRUE,5139856,3018,708,2310,1863
bitos,FALSE,5139272,2872,654,2218,1763
vitro,FALSE,5139252,2973,566,2407,1769.5
easer,FALSE,5139135,3420,986,2434,2203
atimy,FALSE,5138994,2938,916,2022,1927
racks,FALSE,5138897,3014,556,2458,1785
white,TRUE,5138893,2943,1056,1887,1999.5
burst,TRUE,5138679,2846,946,1900,1896
purin,FALSE,5138510,2837,779,2058,1808
ickle,FALSE,5138300,3001,672,2329,1836.5
brief,TRUE,5138146,3014,1050,1964,2032
barps,FALSE,5137772,2977,726,2251,1851.5
lauch,FALSE,5137268,2841,848,1993,1844.5
eight,TRUE,5137079,3049,622,2427,1835.5
naiks,FALSE,5136856,2926,698,2228,1812
wages,FALSE,5136658,3077,808,2269,1942.5
demos,FALSE,5136590,3015,582,2433,1798.5
linds,FALSE,5136578,2833,534,2299,1683.5
clipt,FALSE,5136553,2756,968,1788,1862
gavel,TRUE,5136539,3062,942,2120,2002
askoi,FALSE,5136496,3049,312,2737,1680.5
habit,TRUE,5136310,2869,841,2028,1855
pansy,TRUE,5136036,2840,1120,1720,1980
predy,FALSE,5135782,3026,1019,2007,2022.5
dowle,FALSE,5135653,2941,1002,1939,1971.5
domal,FALSE,5135534,2898,770,2128,1834
ylems,FALSE,5135486,3037,488,2549,1762.5
sworn,TRUE,5135350,2872,936,1936,1904
grith,FALSE,5135305,2830,926,1904,1878
modal,TRUE,5134890,2898,780,2118,1839
gulas,FALSE,5134885,2932,612,2320,1772
perdy,FALSE,5134859,3026,980,2046,2003
began,TRUE,5134683,3082,775,2307,1928.5
cleik,FALSE,5134407,3001,847,2154,1924
evils,FALSE,5134284,3118,551,2567,1834.5
haven,TRUE,5134280,3043,870,2173,1956.5
corms,FALSE,5134260,2874,744,2130,1809
visor,TRUE,5134228,2924,669,2255,1796.5
tryps,FALSE,5134164,2885,531,2354,1708
toked,FALSE,5134070,2968,876,2092,1922
odahs,FALSE,5133766,2949,432,2517,1690.5
paves,FALSE,5133736,3078,849,2229,1963.5
spout,TRUE,5133193,2761,1006,1755,1883.5
dowie,FALSE,5133163,2940,998,1942,1969
tranq,FALSE,5132562,2992,905,2087,1948.5
mayos,FALSE,5132371,2915,608,2307,1761.5
spahi,FALSE,5132269,2899,773,2126,1836
scrog,FALSE,5132259,2876,742,2134,1809
wames,FALSE,5132070,3075,802,2273,1938.5
mined,FALSE,5132042,2921,884,2037,1902.5
amove,FALSE,5131974,3085,893,2192,1989
dashi,FALSE,5131923,2923,534,2389,1728.5
wreak,TRUE,5131585,3198,803,2395,2000.5
gimel,FALSE,5131540,2949,852,2097,1900.5
grisy,FALSE,5131534,2819,1183,1636,2001
croft,FALSE,5131268,2832,997,1835,1914.5
micro,TRUE,5130899,2903,575,2328,1739
dosha,FALSE,5130883,2949,562,2387,1755.5
boric,FALSE,5130819,2872,804,2068,1838
crare,FALSE,5130750,3250,1348,1902,2299
dopas,FALSE,5130719,2916,647,2269,1781.5
vaned,FALSE,5130719,3034,922,2112,1978
impel,TRUE,5130118,2995,604,2391,1799.5
tzars,FALSE,5130036,3066,646,2420,1856
thief,TRUE,5129774,2956,903,2053,1929.5
genus,FALSE,5129700,2981,614,2367,1797.5
caput,TRUE,5129682,2827,895,1932,1861
cutin,FALSE,5128168,2769,783,1986,1776
viper,TRUE,5128130,3035,833,2202,1934
cloys,FALSE,5128127,2804,682,2122,1743
garbo,FALSE,5128081,2986,664,2322,1825
bergs,FALSE,5127740,3078,690,2388,1884
bower,FALSE,5127686,3027,1008,2019,2017.5
daven,FALSE,5127545,3034,912,2122,1973
sidha,FALSE,5127545,2923,735,2188,1829
dreks,FALSE,5127371,3083,646,2437,1864.5
proyn,FALSE,5127318,2823,786,2037,1804.5
xenia,FALSE,5127249,3199,603,2596,1901
seals,FALSE,5126962,3231,1113,2118,2172
unrid,FALSE,5126921,2861,559,2302,1710
murti,FALSE,5126763,2906,606,2300,1756
vitas,FALSE,5126660,2990,555,2435,1772.5
grume,FALSE,5126515,2948,1039,1909,1993.5
oculi,FALSE,5126140,2873,419,2454,1646
vrils,FALSE,5125756,2899,774,2125,1836.5
bield,FALSE,5125585,2988,832,2156,1910
menus,FALSE,5125428,2979,606,2373,1792.5
while,TRUE,5125233,2924,1079,1845,2001.5
skiey,FALSE,5125212,2940,1324,1616,2132
kylie,FALSE,5125172,2970,737,2233,1853.5
graft,TRUE,5124253,2920,977,1943,1948.5
strum,FALSE,5124246,2877,730,2147,1803.5
rived,FALSE,5124240,3059,792,2267,1925.5
vicar,TRUE,5123984,2990,676,2314,1833
vents,FALSE,5123969,3040,599,2441,1819.5
lanks,FALSE,5123958,2927,622,2305,1774.5
gorsy,FALSE,5123656,2845,1092,1753,1968.5
aight,FALSE,5123069,2902,691,2211,1796.5
berms,FALSE,5122922,3076,682,2394,1879
basic,TRUE,5122639,2889,746,2143,1817.5
meths,FALSE,5122197,3018,524,2494,1771
vairy,FALSE,5121772,2959,1129,1830,2044
margs,FALSE,5121647,2962,686,2276,1824
yorps,FALSE,5121644,2891,534,2357,1712.5
ahind,FALSE,5121580,2855,851,2004,1853
elate,TRUE,5121339,3280,1143,2137,2211.5
vapes,FALSE,5121130,3078,759,2319,1918.5
garms,FALSE,5121101,2962,686,2276,1824
ganef,FALSE,5120878,3022,902,2120,1962
towed,FALSE,5120806,2960,890,2070,1925
whose,TRUE,5120668,2920,1066,1854,1993
porny,FALSE,5120666,2823,1130,1693,1976.5
decoy,TRUE,5120495,2964,905,2059,1934.5
yirds,FALSE,5120083,2889,476,2413,1682.5
hends,FALSE,5119622,2973,555,2418,1764
boned,FALSE,5119523,2916,1027,1889,1971.5
prods,FALSE,5119377,2844,758,2086,1801
sting,TRUE,5119011,2782,932,1850,1857
tatie,FALSE,5118650,3279,1146,2133,2212.5
micas,FALSE,5118307,2920,564,2356,1742
twerp,FALSE,5118279,3100,578,2522,1839
picot,FALSE,5118132,2781,785,1996,1783
gyals,FALSE,5117817,2892,643,2249,1767.5
furan,FALSE,5117474,2960,778,2182,1869
orixa,FALSE,5117318,3103,641,2462,1872
manic,TRUE,5117157,2852,739,2113,1795.5
punce,FALSE,5116513,2857,1043,1814,1950
kisan,FALSE,5116340,2926,595,2331,1760.5
turbo,TRUE,5116242,2901,580,2321,1740.5
sicht,FALSE,5115962,2759,905,1854,1832
dewan,FALSE,5115735,3079,672,2407,1875.5
nertz,FALSE,5115703,3145,585,2560,1865
techy,FALSE,5115588,2967,839,2128,1903
oumas,FALSE,5115363,2955,487,2468,1721
hardy,TRUE,5115233,2912,969,1943,1940.5
zaris,FALSE,5114974,3046,664,2382,1855
coady,FALSE,5114953,2817,1217,1600,2017
balus,FALSE,5114854,2899,707,2192,1803
kiley,FALSE,5114746,2970,1016,1954,1993
lawns,FALSE,5114736,2919,636,2283,1777.5
stich,FALSE,5114678,2759,1000,1759,1879.5
thagi,FALSE,5114566,2902,687,2215,1794.5
narre,FALSE,5114487,3352,1080,2272,2216
poilu,FALSE,5114286,2771,850,1921,1810.5
areal,FALSE,5113956,3450,904,2546,2177
lumas,FALSE,5113881,2930,534,2396,1732
goads,FALSE,5113752,2870,806,2064,1838
doily,FALSE,5113639,2755,1182,1573,1968.5
drops,FALSE,5113189,2844,708,2136,1776
fleam,FALSE,5112632,3118,719,2399,1918.5
roums,FALSE,5112628,2883,653,2230,1768
fibre,TRUE,5112562,3014,971,2043,1992.5
sward,FALSE,5112512,2928,987,1941,1957.5
muirs,FALSE,5112461,2857,747,2110,1802
coped,FALSE,5112460,2893,971,1922,1932
sprod,FALSE,5112449,2844,840,2004,1842
savin,FALSE,5112394,2873,1007,1866,1940
spend,TRUE,5111836,2940,904,2036,1922
scold,TRUE,5111790,2757,930,1827,1843.5
ingot,TRUE,5111616,2837,573,2264,1705
oxers,FALSE,5111577,3221,420,2801,1820.5
girly,TRUE,5111515,2849,1006,1843,1927.5
flake,TRUE,5111326,3022,1123,1899,2072.5
grype,FALSE,5111315,2956,885,2071,1920.5
sizel,FALSE,5111284,3004,1053,1951,2028.5
tongs,FALSE,5110491,2808,679,2129,1743.5
flied,FALSE,5110191,2928,1039,1889,1983.5
terne,FALSE,5110027,3110,1160,1950,2135
silva,FALSE,5109918,2971,790,2181,1880.5
ducat,FALSE,5109889,2851,769,2082,1810
houts,FALSE,5109718,2794,688,2106,1741
educt,FALSE,5109654,2998,662,2336,1830
tunic,TRUE,5109590,2769,663,2106,1716
ovule,FALSE,5109428,2983,807,2176,1895
turms,FALSE,5109262,2877,602,2275,1739.5
scrim,FALSE,5108938,2848,769,2079,1808.5
moyas,FALSE,5108563,2915,614,2301,1764.5
crusy,FALSE,5108419,2777,1165,1612,1971
borty,FALSE,5108384,2861,1118,1743,1989.5
choli,FALSE,5108382,2795,759,2036,1777
helms,FALSE,5108278,2999,527,2472,1763
pokie,FALSE,5108270,2924,1015,1909,1969.5
heare,FALSE,5108163,3181,1194,1987,2187.5
gusla,FALSE,5108155,2932,607,2325,1769.5
urare,FALSE,5107932,3259,1183,2076,2221
bides,FALSE,5107825,2958,804,2154,1881
salle,FALSE,5107675,3231,1368,1863,2299.5
fiber,TRUE,5107658,3014,925,2089,1969.5
senza,FALSE,5107583,3168,831,2337,1999.5
soote,FALSE,5107576,3014,1452,1562,2233
yarks,FALSE,5107463,2983,564,2419,1773.5
fices,FALSE,5107352,2976,748,2228,1862
mirly,FALSE,5107243,2847,998,1849,1922.5
relet,FALSE,5107096,3208,1030,2178,2119
punas,FALSE,5106983,2880,666,2214,1773
enows,FALSE,5106522,3091,464,2627,1777.5
brags,FALSE,5106444,2931,859,2072,1895
paged,FALSE,5105901,2981,949,2032,1965
opahs,FALSE,5105775,2925,473,2452,1699
tozes,FALSE,5105340,3049,793,2256,1921
thraw,FALSE,5105065,2986,636,2350,1811
apods,FALSE,5104860,2916,551,2365,1733.5
trite,TRUE,5104784,3207,1245,1962,2226
sores,FALSE,5104782,3184,1162,2022,2173
kyars,FALSE,5104766,2983,538,2445,1760.5
obits,FALSE,5104658,2872,498,2374,1685
licht,FALSE,5104480,2789,627,2162,1708
lusty,TRUE,5104160,2807,857,1950,1832
rejon,FALSE,5104114,3143,612,2531,1877.5
tubas,FALSE,5104046,2918,591,2327,1754.5
pyros,FALSE,5103894,2891,496,2395,1693.5
beady,TRUE,5103615,3019,1155,1864,2087
sodic,FALSE,5103546,2756,909,1847,1832.5
spurn,TRUE,5103479,2808,874,1934,1841
dwile,FALSE,5103435,2915,1007,1908,1961
thous,FALSE,5103278,2794,655,2139,1724.5
opsin,FALSE,5103231,2834,470,2364,1652
tabid,FALSE,5103002,2860,786,2074,1823
douts,FALSE,5102983,2785,730,2055,1757.5
gelds,FALSE,5102632,2992,574,2418,1783
tetra,FALSE,5102578,3469,718,2751,2093.5
tabun,FALSE,5102364,2850,722,2128,1786
duple,FALSE,5102309,2877,941,1936,1909
deign,TRUE,5102307,2923,825,2098,1874
durns,FALSE,5102283,2832,678,2154,1755
cloak,TRUE,5102256,2880,919,1961,1899.5
yagis,FALSE,5102173,2891,571,2320,1731
curly,TRUE,5102082,2807,1073,1734,1940
puces,FALSE,5102008,2925,738,2187,1831.5
ixtle,FALSE,5101998,3055,745,2310,1900
galop,FALSE,5101989,2876,719,2157,1797.5
dowse,FALSE,5101888,2911,1011,1900,1961
broth,TRUE,5101808,2823,962,1861,1892.5
saick,FALSE,5101785,2824,1201,1623,2012.5
gazer,TRUE,5101587,3137,960,2177,2048.5
kithe,FALSE,5101528,2951,785,2166,1868
deare,FALSE,5101428,3172,1236,1936,2204
gurls,FALSE,5100881,2860,662,2198,1761
benty,FALSE,5100815,2957,1057,1900,2007
hotly,TRUE,5100764,2784,985,1799,1884.5
tempi,FALSE,5100679,3014,513,2501,1763.5
ycled,FALSE,5100490,2939,594,2345,1766.5
dowel,TRUE,5100389,2941,890,2051,1915.5
mourn,TRUE,5100337,2815,833,1982,1824
terra,TRUE,5100334,3469,770,2699,2119.5
grabs,FALSE,5100265,2931,749,2182,1840
neums,FALSE,5099913,2979,548,2431,1763.5
jarls,FALSE,5099484,3039,685,2354,1862
gaped,FALSE,5099301,2981,913,2068,1947
rares,FALSE,5099177,3420,926,2494,2173
slurb,FALSE,5099165,2827,895,1932,1861
ikans,FALSE,5099076,2926,569,2357,1747.5
silex,FALSE,5099018,3006,1006,2000,2006
foyne,FALSE,5098920,2903,1050,1853,1976.5
ghats,FALSE,5098533,2873,741,2132,1807
tangy,TRUE,5098533,2843,1032,1811,1937.5
rhyme,TRUE,5098426,2987,770,2217,1878.5
yogas,FALSE,5098385,2917,551,2366,1734
melds,FALSE,5098360,2990,566,2424,1778
brosy,FALSE,5098037,2812,1219,1593,2015.5
mover,TRUE,5097903,3013,965,2048,1989
cruve,FALSE,5097422,2947,1100,1847,2023.5
mazer,FALSE,5097315,3135,952,2183,2043.5
torte,FALSE,5096906,3233,1154,2079,2193.5
kinas,FALSE,5096781,2926,560,2366,1743
lytic,FALSE,5096757,2827,411,2416,1619
poems,FALSE,5096725,2991,702,2289,1846.5
moult,TRUE,5096687,2743,966,1777,1854.5
murls,FALSE,5096609,2858,654,2204,1756
wince,TRUE,5096532,2895,1000,1895,1947.5
felty,FALSE,5096118,2995,993,2002,1994
hiems,FALSE,5095711,2998,552,2446,1775
gript,FALSE,5095625,2797,951,1846,1874
guans,FALSE,5095579,2834,826,2008,1830
gadso,FALSE,5095443,2870,723,2147,1796.5
taluk,FALSE,5095359,2883,760,2123,1821.5
topic,TRUE,5095169,2781,675,2106,1728
biker,FALSE,5095044,3009,917,2092,1963
manty,FALSE,5094722,2841,1053,1788,1947
octyl,FALSE,5094322,2853,351,2502,1602
soole,FALSE,5093916,2995,1475,1520,2235
trock,FALSE,5093707,2827,925,1902,1876
stere,FALSE,5093462.5,3178,1196,1982,2187
avion,FALSE,5093456,2928,684,2244,1806
egmas,FALSE,5093181,3181,344,2837,1762.5
fruit,TRUE,5092990,2815,979,1836,1897
vista,TRUE,5092906,2990,528,2462,1759
braze,FALSE,5092794,3104,1191,1913,2147.5
tasse,FALSE,5092667.5,3250,1128,2122,2189
demon,TRUE,5092242,2947,676,2271,1811.5
slack,TRUE,5092200,2825,1139,1686,1982
bruts,FALSE,5091946,2846,780,2066,1813
withe,FALSE,5091749,2943,848,2095,1895.5
vomer,FALSE,5091581,3013,913,2100,1963
bilge,TRUE,5091408,2918,987,1931,1952.5
brunt,TRUE,5091324,2778,1040,1738,1909
gleds,FALSE,5091042,2992,598,2394,1795
fakie,FALSE,5091022,3021,1034,1987,2027.5
pluto,FALSE,5090935,2791,705,2086,1748
pekan,FALSE,5090842,3063,689,2374,1876
caked,FALSE,5090570,2985,950,2035,1967.5
topek,FALSE,5090439,2944,917,2027,1930.5
begot,FALSE,5090117,2963,867,2096,1915
rebuy,FALSE,5089838,3034,850,2184,1942
tromp,FALSE,5089636,2821,784,2037,1802.5
glout,FALSE,5089394,2745,895,1850,1820
paven,FALSE,5089388,3010,943,2067,1976.5
admit,TRUE,5088931,2891,633,2258,1762
courd,FALSE,5088786,2785,912,1873,1848.5
taste,TRUE,5088726,3250,1096,2154,2173
lingo,TRUE,5088721,2818,563,2255,1690.5
cabin,TRUE,5088484,2821,847,1974,1834
blash,FALSE,5088296,2821,991,1830,1906
perks,FALSE,5088291,3059,638,2421,1848.5
bakes,FALSE,5088044,3052,843,2209,1947.5
gyred,FALSE,5086825,2980,737,2243,1858.5
rioja,FALSE,5086734,3093,617,2476,1855
hoyed,FALSE,5086418,2895,813,2082,1854
draws,FALSE,5085940,2928,746,2182,1837
negus,FALSE,5085888,2981,464,2517,1722.5
scaud,FALSE,5085824,2802,913,1889,1857.5
varus,FALSE,5085768,2970,628,2342,1799
calif,FALSE,5085658,2859,798,2061,1828.5
sugan,FALSE,5085603,2834,912,1922,1873
neigh,TRUE,5085393,2932,760,2172,1846
sowed,FALSE,5085386,2911,1107,1804,2009
bacon,TRUE,5085248,2847,795,2052,1821
quire,FALSE,5085164,3026,1051,1975,2038.5
guyle,FALSE,5084425,2878,916,1962,1897
temps,FALSE,5084185,2985,538,2447,1761.5
aglus,FALSE,5084100,2932,383,2549,1657.5
eruvs,FALSE,5084084,3117,586,2531,1851.5
magot,FALSE,5084024,2847,863,1984,1855
drips,FALSE,5083989,2818,730,2088,1774
lurgi,FALSE,5083672,2889,524,2365,1706.5
debur,FALSE,5083119,2987,704,2283,1845.5
fetus,TRUE,5082990,3005,607,2398,1806
capul,FALSE,5082692,2808,798,2010,1803
conga,FALSE,5082445,2880,756,2124,1818
algid,FALSE,5082360,2874,685,2189,1779.5
spoke,TRUE,5081762,2895,1150,1745,2022.5
girth,TRUE,5081521,2830,758,2072,1794
manly,TRUE,5081062,2822,1076,1746,1949
vinal,FALSE,5080877,2903,703,2200,1803
bleys,FALSE,5080634,3006,590,2416,1798
spark,TRUE,5080594,2912,999,1913,1955.5
kelty,FALSE,5080572,2990,877,2113,1933.5
lefty,TRUE,5080260,2995,858,2137,1926.5
plasm,FALSE,5080174,2819,863,1956,1841
looie,FALSE,5079944,3024,1193,1831,2108.5
faced,FALSE,5079928,2990,932,2058,1961
latte,TRUE,5079658,3280,1066,2214,2173
lyams,FALSE,5079296,2890,522,2368,1706
hemin,FALSE,5078957,2930,660,2270,1795
march,TRUE,5078937,2871,865,2006,1868
guard,TRUE,5078747,2873,878,1995,1875.5
gaids,FALSE,5078408,2844,790,2054,1817
conus,FALSE,5078341,2746,734,2012,1740
gamey,FALSE,5078218,2980,1162,1818,2071
cribs,FALSE,5078080,2817,791,2026,1804
wetly,FALSE,5077817,2982,962,2020,1972
jager,FALSE,5077775,3129,921,2208,2025
cawed,FALSE,5077306,2977,964,2013,1970.5
mirth,TRUE,5077249,2828,750,2078,1789
abuts,FALSE,5076766,2918,497,2421,1707.5
dagos,FALSE,5076660,2870,650,2220,1760
hacek,FALSE,5076547,2994,860,2134,1927
chits,FALSE,5076348,2759,783,1976,1771
dorps,FALSE,5076111,2844,639,2205,1741.5
focal,TRUE,5075992,2885,790,2095,1837.5
debts,FALSE,5075983,2978,585,2393,1781.5
thegn,FALSE,5075943,2952,676,2276,1814
clods,FALSE,5075838,2757,748,2009,1752.5
knead,TRUE,5075622,3087,565,2522,1826
flour,TRUE,5075259,2822,875,1947,1848.5
drank,TRUE,5075152,2868,980,1888,1924
coths,FALSE,5075110,2785,652,2133,1718.5
bantu,FALSE,5075101,2850,756,2094,1803
donut,TRUE,5075084,2717,864,1853,1790.5
banco,FALSE,5075075,2847,826,2021,1836.5
unrip,FALSE,5075049,2837,497,2340,1667
gibel,FALSE,5074803,2918,848,2070,1883
pends,FALSE,5074730,2940,628,2312,1784
maids,FALSE,5074136,2842,782,2060,1812
kited,FALSE,5074058,2942,769,2173,1855.5
lowed,FALSE,5073904,2941,829,2112,1885
cowal,FALSE,5073370,2872,822,2050,1847
stoup,FALSE,5072736,2761,825,1936,1793
brith,FALSE,5072608,2797,984,1813,1890.5
roque,FALSE,5072588,3052,891,2161,1971.5
acing,FALSE,5072465,2854,670,2184,1762
virls,FALSE,5071972,2899,606,2293,1752.5
yokes,FALSE,5071916,2966,651,2315,1808.5
devas,FALSE,5071875,3102,601,2501,1851.5
boyla,FALSE,5071870,2914,707,2207,1810.5
above,TRUE,5071860,3054,871,2183,1962.5
trait,TRUE,5071382,3060,1134,1926,2097
unket,FALSE,5071381,2932,703,2229,1817.5
dolci,FALSE,5071239,2786,665,2121,1725.5
cymar,FALSE,5071205,2909,657,2252,1783
benga,FALSE,5071107,3082,694,2388,1888
denim,TRUE,5071046,2921,692,2229,1806.5
harpy,TRUE,5070888,2888,950,1938,1919
afoul,TRUE,5070856,2894,631,2263,1762.5
duits,FALSE,5070759,2759,738,2021,1748.5
honda,FALSE,5070558,2881,620,2261,1750.5
ovary,TRUE,5070554,2985,879,2106,1932
balun,FALSE,5070506,2831,801,2030,1816
pardy,FALSE,5070341,2879,1042,1837,1960.5
foils,FALSE,5070192,2793,879,1914,1836
tulip,TRUE,5070130,2765,661,2104,1713
bayts,FALSE,5070076,2878,681,2197,1779.5
ouphe,FALSE,5069512,2911,737,2174,1824
firns,FALSE,5069470,2859,719,2140,1789
charm,TRUE,5069392,2871,843,2028,1857
filed,FALSE,5068920,2928,886,2042,1907
glads,FALSE,5068823,2845,728,2117,1786.5
guilt,TRUE,5068735,2719,982,1737,1850.5
harks,FALSE,5068665,2945,627,2318,1786
mensh,FALSE,5068161,2901,798,2103,1849.5
gluey,FALSE,5068070,2878,1163,1715,2020.5
ixora,FALSE,5067728,3103,508,2595,1805.5
cangs,FALSE,5066991,2825,753,2072,1789
stack,TRUE,5066783,2844,1015,1829,1929.5
scrob,FALSE,5066772,2843,712,2131,1777.5
fraim,FALSE,5066432,2898,910,1988,1904
sexto,FALSE,5065400,3051,817,2234,1934
fards,FALSE,5065051,2941,708,2233,1824.5
serra,FALSE,5064914,3420,987,2433,2203.5
pouts,FALSE,5064826,2761,761,2000,1761
crush,TRUE,5064765,2739,940,1799,1839.5
minos,FALSE,5064644,2786,616,2170,1701
tings,FALSE,5064585,2782,602,2180,1692
trick,TRUE,5064507,2801,947,1854,1874
wited,FALSE,5064279,2934,832,2102,1883
fraps,FALSE,5063928,2917,796,2121,1856.5
skied,FALSE,5063840,2893,1078,1815,1985.5
brume,FALSE,5063818,2915,1097,1818,2006
beths,FALSE,5063772,2987,590,2397,1788.5
brach,FALSE,5063734,2840,1038,1802,1939
longs,FALSE,5063589,2789,618,2171,1703.5
puled,FALSE,5063576,2877,876,2001,1876.5
rente,FALSE,5063388,3110,1049,2061,2079.5
peare,FALSE,5063271,3148,1267,1881,2207.5
ictus,FALSE,5063260,2837,303,2534,1570
loxes,FALSE,5062960,3032,733,2299,1882.5
moust,FALSE,5062922,2713,975,1738,1844
ducal,FALSE,5062899,2832,672,2160,1752
sloyd,FALSE,5062877,2726,932,1794,1829
stamp,TRUE,5062712,2838,874,1964,1856
kidel,FALSE,5062483,2923,771,2152,1847
coves,FALSE,5062428,2944,880,2064,1912
uplit,FALSE,5062421,2765,617,2148,1691
trest,FALSE,5062326,3178,1017,2161,2097.5
virge,FALSE,5062322,2989,908,2081,1948.5
croup,TRUE,5062304,2761,847,1914,1804
rindy,FALSE,5062088,2821,879,1942,1850
gaths,FALSE,5061951,2873,594,2279,1733.5
darks,FALSE,5061930,2936,669,2267,1802.5
yacht,TRUE,5061804,2820,647,2173,1733.5
frust,FALSE,5061715,2786,992,1794,1889
yauld,FALSE,5061526,2801,755,2046,1778
delft,FALSE,5061473,2948,753,2195,1850.5
troat,FALSE,5061450,3086,1076,2010,2081
manus,FALSE,5060910,2832,668,2164,1750
mints,FALSE,5060774,2780,623,2157,1701.5
gnome,TRUE,5060726,2877,938,1939,1907.5
inbye,FALSE,5060035,2937,605,2332,1771
thang,FALSE,5059695,2805,823,1982,1814
vants,FALSE,5059451,2893,661,2232,1777
tizes,FALSE,5059434,3023,716,2307,1869.5
fluor,FALSE,5059425,2822,846,1976,1834
fuels,FALSE,5059257,2986,697,2289,1841.5
amido,FALSE,5058985,2897,572,2325,1734.5
sires,FALSE,5058876,3158,1085,2073,2121.5
shily,FALSE,5058810,2709,1302,1407,2005.5
yowes,FALSE,5058652,2958,665,2293,1811.5
reset,TRUE,5058634,3178,998,2180,2088
blays,FALSE,5058415,2859,720,2139,1789.5
barms,FALSE,5058404,2929,744,2185,1836.5
rheum,FALSE,5058291,3027,550,2477,1788.5
carby,FALSE,5058244,2878,1053,1825,1965.5
sorer,FALSE,5058188,3184,1338,1846,2261
unwet,FALSE,5058117,2924,717,2207,1820.5
nazir,FALSE,5057813,2978,722,2256,1850
maths,FALSE,5057679,2871,586,2285,1728.5
curve,TRUE,5057320,2947,1017,1930,1982
beaks,FALSE,5057047,3052,813,2239,1932.5
garbs,FALSE,5057043,2931,642,2289,1786.5
taxol,FALSE,5056404,2934,753,2181,1843.5
norks,FALSE,5056280,2880,570,2310,1725
giver,TRUE,5056269,2989,896,2093,1942.5
gadis,FALSE,5055680,2844,688,2156,1766
cunts,FALSE,5055613,2740,698,2042,1719
hands,FALSE,5055104,2826,617,2209,1721.5
homas,FALSE,5054999,2877,608,2269,1742.5
bleak,TRUE,5054763,3082,827,2255,1954.5
kirns,FALSE,5053924,2854,603,2251,1728.5
izars,FALSE,5053676,3046,531,2515,1788.5
crudo,FALSE,5053633,2785,757,2028,1771
sheva,FALSE,5053255,3111,797,2314,1954
incut,FALSE,5053251,2769,512,2257,1640.5
clefs,FALSE,5053140,2977,647,2330,1812
spike,TRUE,5052562,2869,1172,1697,2020.5
agony,TRUE,5052524,2849,943,1906,1896
dolma,FALSE,5052479,2898,634,2264,1766
abrim,FALSE,5052398,2958,520,2438,1739
alane,FALSE,5052334,3163,1255,1908,2209
cramp,TRUE,5052280,2838,896,1942,1867
adbot,FALSE,5052214,2886,603,2283,1744.5
wroke,FALSE,5052088,2962,1073,1889,2017.5
oorie,FALSE,5051969,3213,1065,2148,2139
pervo,FALSE,5051890,3061,651,2410,1856
toter,FALSE,5051512,3233,1069,2164,2151
runds,FALSE,5051454,2832,535,2297,1683.5
colds,FALSE,5051273,2757,694,2063,1725.5
burnt,TRUE,5051222,2778,957,1821,1867.5
joles,FALSE,5051042,3022,765,2257,1893.5
right,TRUE,5050673,2830,655,2175,1742.5
guyse,FALSE,5050660,2848,925,1923,1886.5
spued,FALSE,5050497,2847,1028,1819,1937.5
carer,FALSE,5050108,3250,1195,2055,2222.5
vault,TRUE,5049458,2830,927,1903,1878.5
urvas,FALSE,5049358,2970,548,2422,1759
cyton,FALSE,5049204,2755,594,2161,1674.5
bronc,FALSE,5049165,2775,897,1878,1836
churl,FALSE,5048960,2769,815,1954,1792
omlah,FALSE,5048928,2907,493,2414,1700
loose,TRUE,5048669,2995,1206,1789,2100.5
doabs,FALSE,5048605,2837,757,2080,1797
rears,FALSE,5048504,3420,842,2578,2131
situp,FALSE,5048366,2735,817,1918,1776
ovens,FALSE,5048233,3046,451,2595,1748.5
aphis,FALSE,5048231,2899,405,2494,1652
chime,TRUE,5048220,2828,1100,1728,1964
tarot,TRUE,5048180,3086,1001,2085,2043.5
rimus,FALSE,5048109,2857,486,2371,1671.5
state,TRUE,5047732,3250,1313,1937,2281.5
festy,FALSE,5047656,2965,961,2004,1963
fauts,FALSE,5047578,2858,780,2078,1819
shunt,TRUE,5047532,2671,1110,1561,1890.5
luxer,FALSE,5047368,3035,816,2219,1925.5
sleer,FALSE,5047248.5,3159,1274,1885,2216.5
lovey,FALSE,5047068,2943,1098,1845,2020.5
ruing,FALSE,5046845,2791,780,2011,1785.5
awoke,TRUE,5046541,3034,908,2126,1971
nurds,FALSE,5046308,2832,491,2341,1661.5
sahib,FALSE,5046116,2820,848,1972,1834
gland,TRUE,5045818,2777,923,1854,1850
smout,FALSE,5045480,2713,983,1730,1848
becap,FALSE,5045104,3026,690,2336,1858
dovie,FALSE,5044955,2895,1021,1874,1958
bhels,FALSE,5044395,2968,692,2276,1830
narky,FALSE,5044322,2915,923,1992,1919
madge,FALSE,5044248,2933,986,1947,1959.5
halms,FALSE,5043760,2852,589,2263,1720.5
guide,TRUE,5043720,2830,1060,1770,1945
baken,FALSE,5043696,2984,937,2047,1960.5
wiled,FALSE,5043595,2915,833,2082,1874
shove,TRUE,5043248,2875,1224,1651,2049.5
nival,FALSE,5043071,2903,607,2296,1755
yonic,FALSE,5042604,2735,613,2122,1674
ouped,FALSE,5042042,2902,721,2181,1811.5
teres,FALSE,5041988,3178,908,2270,2043
bourn,FALSE,5041912,2784,899,1885,1841.5
drawn,TRUE,5041592,2860,840,2020,1850
blurs,FALSE,5041331,2827,727,2100,1777
chave,FALSE,5041312,2941,1119,1822,2030
liked,FALSE,5041262,2923,738,2185,1830.5
sound,TRUE,5040368,2668,1110,1558,1889
parki,FALSE,5040267,2941,675,2266,1808
erose,FALSE,5040001,3184,1178,2006,2181
tykes,FALSE,5039918,2960,538,2422,1749
wards,FALSE,5039726,2928,655,2273,1791.5
inspo,FALSE,5039665,2834,309,2525,1571.5
fetid,TRUE,5039280,2947,765,2182,1856
imbar,FALSE,5039008,2958,504,2454,1731
flits,FALSE,5038923,2787,778,2009,1782.5
fatly,FALSE,5038624,2848,1077,1771,1962.5
pious,FALSE,5038624,2741,706,2035,1723.5
wraps,FALSE,5038603,2904,743,2161,1823.5
anvil,TRUE,5038433,2903,591,2312,1747
flint,TRUE,5038301,2719,1038,1681,1878.5
boult,FALSE,5038262,2712,1032,1680,1872
burls,FALSE,5038184,2827,720,2107,1773.5
unity,TRUE,5038037,2738,889,1849,1813.5
fogle,FALSE,5037535,2884,1068,1816,1976
toshy,FALSE,5037506,2754,900,1854,1827
primo,TRUE,5037502,2801,801,2000,1801
minge,FALSE,5037464,2851,948,1903,1899.5
prank,TRUE,5036995,2844,1011,1833,1927.5
phyle,FALSE,5036964,2846,901,1945,1873.5
poach,FALSE,5036614,2755,1019,1736,1887
taxed,FALSE,5036532,3039,901,2138,1970
dopey,TRUE,5036315,2862,1130,1732,1996
maybe,TRUE,5036315,2947,888,2059,1917.5
banty,FALSE,5036297,2810,1119,1691,1964.5
muley,FALSE,5036209,2876,1087,1789,1981.5
bhats,FALSE,5035836,2840,799,2041,1819.5
sensa,FALSE,5035191.5,3133,982,2151,2057.5
fogie,FALSE,5035045,2883,1064,1819,1973.5
anomy,FALSE,5034579,2847,904,1943,1875.5
voces,FALSE,5034538,2944,732,2212,1838
eying,TRUE,5034267,2970,584,2386,1777
genip,FALSE,5034118,2899,710,2189,1804.5
girsh,FALSE,5034096,2781,790,1991,1785.5
scaup,FALSE,5033952,2778,851,1927,1814.5
vapor,TRUE,5033308,2914,749,2165,1831.5
exact,TRUE,5033194,3117,798,2319,1957.5
swipe,FALSE,5033140,2861,1150,1711,2005.5
hokes,FALSE,5033118,2928,714,2214,1821
sanes,FALSE,5032695,3133,1163,1970,2148
tifos,FALSE,5032566,2812,544,2268,1678
rizas,FALSE,5032446,3046,517,2529,1781.5
gapos,FALSE,5031903,2846,645,2201,1745.5
nempt,FALSE,5031778,2917,643,2274,1780
clops,FALSE,5031493,2733,729,2004,1731
bruin,FALSE,5031448,2758,893,1865,1825.5
disco,TRUE,5031415,2756,603,2153,1679.5
amnic,FALSE,5030968,2852,507,2345,1679.5
tokay,FALSE,5030906,2868,967,1901,1917.5
muist,FALSE,5030698,2687,983,1704,1835
ragee,FALSE,5030524,3102,1218,1884,2160
oxies,FALSE,5030014,3031,675,2356,1853
jurel,FALSE,5029532,3025,843,2182,1934
obeys,FALSE,5029303,3031,273,2758,1652
purda,FALSE,5029255,2919,624,2295,1771.5
mobes,FALSE,5029167,2912,797,2115,1854.5
thelf,FALSE,5029079,2957,658,2299,1807.5
boeps,FALSE,5028929,2960,715,2245,1837.5
lound,FALSE,5028886,2698,832,1866,1765
amyls,FALSE,5028652,2890,406,2484,1648
easle,FALSE,5028508,3231,1042,2189,2136.5
upsey,FALSE,5028489,2894,856,2038,1875
faith,TRUE,5028240,2809,984,1825,1896.5
lofts,FALSE,5027700,2813,567,2246,1690
slopy,FALSE,5027615,2702,1225,1477,1963.5
ylkes,FALSE,5026987,2941,573,2368,1757
rases,FALSE,5026899,3420,843,2577,2131.5
seirs,FALSE,5026894,3158,1062,2096,2110
pengo,FALSE,5026873,2925,657,2268,1791
areas,FALSE,5026686,3420,784,2636,2102
arses,FALSE,5026597,3420,842,2578,2131
clews,FALSE,5026463,2964,637,2327,1800.5
mbira,FALSE,5026217,2958,605,2353,1781.5
yikes,FALSE,5026010,2940,574,2366,1757
ramee,FALSE,5025936,3100,1212,1888,2156
furol,FALSE,5025918,2822,773,2049,1797.5
zerda,FALSE,5025889,3207,541,2666,1874
kytes,FALSE,5025812,2960,508,2452,1734
bison,TRUE,5025778,2755,717,2038,1736
diebs,FALSE,5024918,2958,550,2408,1754
chiru,FALSE,5024810,2768,761,2007,1764.5
lurex,FALSE,5024662,3035,763,2272,1899
lurch,TRUE,5024468,2769,728,2041,1748.5
talky,FALSE,5024289,2843,984,1859,1913.5
fayed,FALSE,5024278,2959,905,2054,1932
parks,FALSE,5023773,2912,700,2212,1806
otaku,FALSE,5022965,2908,481,2427,1694.5
anele,FALSE,5022953.5,3163,991,2172,2077
cease,TRUE,5022922,3031,1342,1689,2186.5
hauld,FALSE,5022728,2763,818,1945,1790.5
fermi,FALSE,5022350,3045,620,2425,1832.5
potsy,FALSE,5022107,2721,1067,1654,1894
steer,TRUE,5021831.5,3178,1150,2028,2164
limns,FALSE,5021529,2761,569,2192,1665
giust,FALSE,5021288,2689,906,1783,1797.5
yucas,FALSE,5021162,2849,447,2402,1648
blins,FALSE,5021107,2730,858,1872,1794
duroc,FALSE,5020680,2785,623,2162,1704
fyles,FALSE,5020674,2946,625,2321,1785.5
theow,FALSE,5020030,2969,619,2350,1794
howes,FALSE,5019854,2920,728,2192,1824
bhais,FALSE,5019686,2820,818,2002,1819
tamps,FALSE,5019667,2838,600,2238,1719
sangh,FALSE,5019459,2756,1024,1732,1890
gyros,FALSE,5019427,2845,469,2376,1657
foram,FALSE,5019422,2924,783,2141,1853.5
ronne,FALSE,5019172.5,3116,1129,1987,2122.5
dervs,FALSE,5019009,3030,598,2432,1814
hovel,TRUE,5018916,2905,871,2034,1888
birth,TRUE,5018824,2797,816,1981,1806.5
felid,FALSE,5018596,2928,766,2162,1847
hazel,TRUE,5018328,3027,858,2169,1942.5
dicts,FALSE,5018159,2750,544,2206,1647
coven,TRUE,5018080,2876,974,1902,1925
pirog,FALSE,5017873,2803,680,2123,1741.5
shaft,TRUE,5017764,2780,1105,1675,1942.5
gonad,TRUE,5017684,2802,814,1988,1808
lings,FALSE,5017683,2763,541,2222,1652
rubli,FALSE,5017384,2856,521,2335,1688.5
rotte,FALSE,5017126,3233,1058,2175,2145.5
prism,TRUE,5017061,2746,888,1858,1817
gloam,FALSE,5017050,2828,765,2063,1796.5
throb,TRUE,5017040,2823,599,2224,1711
ludos,FALSE,5016959,2766,517,2249,1641.5
gamed,FALSE,5016846,2933,916,2017,1924.5
tsuba,FALSE,5016844,2918,418,2500,1668
hejra,FALSE,5016814,3208,530,2678,1869
voted,FALSE,5016790,2915,869,2046,1892
namus,FALSE,5016782,2832,520,2312,1676
talea,FALSE,5016565,3280,947,2333,2113.5
cives,FALSE,5016522,2918,803,2115,1860.5
chapt,FALSE,5016400,2749,952,1797,1850.5
cooer,FALSE,5016208,3014,1251,1763,2132.5
lochs,FALSE,5016126,2766,487,2279,1626.5
wytes,FALSE,5016033,2952,571,2381,1761.5
oller,FALSE,5015624.5,3214,884,2330,2049
upled,FALSE,5015579,2877,642,2235,1759.5
rinks,FALSE,5015520,2854,537,2317,1695.5
hogan,FALSE,5015239,2811,708,2103,1759.5
smerk,FALSE,5015100,3011,846,2165,1928.5
birsy,FALSE,5015053,2786,1073,1713,1929.5
dwelt,TRUE,5014466,2935,747,2188,1841
ditsy,FALSE,5014358,2719,959,1760,1839
notch,TRUE,5014167,2717,718,1999,1717.5
dared,FALSE,5014122.5,3172,1014,2158,2093
lozen,FALSE,5014090,2962,826,2136,1894
shive,FALSE,5014048,2849,1246,1603,2047.5
hilus,FALSE,5014022,2749,501,2248,1625
monad,FALSE,5013412,2800,806,1994,1803
dobla,FALSE,5013259,2867,673,2194,1770
pewit,FALSE,5012992,2910,821,2089,1865.5
chino,FALSE,5012504,2697,848,1849,1772.5
berko,FALSE,5012165,3035,691,2344,1863
premy,FALSE,5012069,2954,1018,1936,1986
redub,FALSE,5011701,2987,515,2472,1751
caups,FALSE,5010948,2778,753,2025,1765.5
titre,FALSE,5010510,3207,1038,2169,2122.5
nould,FALSE,5010343,2698,761,1937,1729.5
guaco,FALSE,5010299,2787,818,1969,1802.5
shakt,FALSE,5010299,2775,1125,1650,1950
pands,FALSE,5010212,2793,690,2103,1741.5
ebony,TRUE,5009410,2963,878,2085,1920.5
copay,FALSE,5009296,2793,1062,1731,1927.5
blahs,FALSE,5009279,2821,745,2076,1783
amped,FALSE,5008840,2979,673,2306,1826
glike,FALSE,5008763,2853,1061,1792,1957
facts,FALSE,5008660,2849,671,2178,1760
wauls,FALSE,5008593,2826,750,2076,1788
field,TRUE,5008519,2928,795,2133,1861.5
dogan,FALSE,5008504,2802,750,2052,1776
igapo,FALSE,5007672,2875,461,2414,1668
loups,FALSE,5007546,2742,618,2124,1680
woald,FALSE,5006881,2794,949,1845,1871.5
glued,FALSE,5006698,2831,917,1914,1874
walty,FALSE,5006275,2835,1002,1833,1918.5
blads,FALSE,5006126,2812,786,2026,1799
built,TRUE,5006038,2686,1040,1646,1863
ferms,FALSE,5005856,3016,645,2371,1830.5
seans,FALSE,5005740,3133,1133,2000,2133
grids,FALSE,5005710,2772,753,2019,1762.5
titer,FALSE,5005606,3207,992,2215,2099.5
bluey,FALSE,5005373,2845,1221,1624,2033
blend,TRUE,5005340,2891,851,2040,1871
kyles,FALSE,5005128,2941,509,2432,1725
bahts,FALSE,5004432,2840,661,2179,1750.5
claws,FALSE,5004244,2817,767,2050,1792
bancs,FALSE,5004037,2792,804,1988,1798
veily,FALSE,5004032,2917,1077,1840,1997
whine,TRUE,5004011,2826,1099,1727,1962.5
prawn,TRUE,5003435,2836,871,1965,1853.5
iched,FALSE,5003422,2900,519,2381,1709.5
owled,FALSE,5002874,2941,633,2308,1787
lowts,FALSE,5002636,2800,568,2232,1684
ganev,FALSE,5002550,2964,876,2088,1920
apism,FALSE,5002544,2818,681,2137,1749.5
bints,FALSE,5002349,2749,689,2060,1719
clips,FALSE,5002293,2707,751,1956,1729
psalm,TRUE,5002254,2819,669,2150,1744
trees,FALSE,5001993.5,3178,947,2231,2062.5
novas,FALSE,5001707,2899,564,2335,1731.5
sycon,FALSE,5001702,2706,707,1999,1706.5
envoi,FALSE,5001687,3075,351,2724,1713
filos,FALSE,5001522,2793,618,2175,1705.5
nervy,FALSE,5001401,3009,852,2157,1930.5
tacks,FALSE,5001349,2844,600,2244,1722
ehing,FALSE,5001323,2932,705,2227,1818.5
basho,FALSE,5001146,2846,643,2203,1744.5
laufs,FALSE,5000830,2839,628,2211,1733.5
sampi,FALSE,5000741,2818,792,2026,1805
maven,FALSE,5000649,2962,908,2054,1935
progs,FALSE,5000482,2774,765,2009,1769.5
adoze,FALSE,5000306,3043,849,2194,1946
calfs,FALSE,5000212,2830,685,2145,1757.5
merks,FALSE,4999552,3011,603,2408,1807
baths,FALSE,4999254,2840,652,2188,1746
wayed,FALSE,4998953,2946,852,2094,1899
palms,FALSE,4998868,2819,662,2157,1740.5
tates,FALSE,4998606,3250,918,2332,2084
woker,FALSE,4998559,2962,904,2058,1933
soars,FALSE,4997720,3037,1140,1897,2088.5
chado,FALSE,4997523,2779,776,2003,1777.5
nauch,FALSE,4997503,2743,797,1946,1770
maare,FALSE,4997475,3100,1294,1806,2197
stewy,FALSE,4997168,2952,1009,1943,1980.5
mihas,FALSE,4997013,2851,517,2334,1684
dorms,FALSE,4996743,2796,657,2139,1726.5
gyans,FALSE,4996595,2794,663,2131,1728.5
teats,FALSE,4996552,3250,873,2377,2061.5
optic,TRUE,4996370,2781,402,2379,1591.5
wurst,FALSE,4996288,2773,856,1917,1814.5
voled,FALSE,4996106,2896,870,2026,1883
proms,FALSE,4995664,2772,757,2015,1764.5
lorel,FALSE,4995642,3214,1004,2210,2109
muted,FALSE,4995521,2848,840,2008,1844
besaw,FALSE,4995491,3044,675,2369,1859.5
warps,FALSE,4995381,2904,636,2268,1770
wyles,FALSE,4995349,2933,572,2361,1752.5
saist,FALSE,4995160.5,2841,1360,1481,2100.5
wised,FALSE,4995133,2885,801,2084,1843
leres,FALSE,4995086,3159,847,2312,2003
chelp,FALSE,4995049,2877,737,2140,1807
pibal,FALSE,4994734,2817,720,2097,1768.5
spacy,FALSE,4994671,2738,1250,1488,1994
exist,TRUE,4994643,3025,776,2249,1900.5
laari,FALSE,4994188,3041,862,2179,1951.5
smoke,TRUE,4994049,2847,1127,1720,1987
shelf,TRUE,4993659,2908,875,2033,1891.5
vinas,FALSE,4993607,2873,583,2290,1728
clank,TRUE,4993456,2757,1001,1756,1879
tuism,FALSE,4993453,2687,814,1873,1750.5
flesh,TRUE,4993449,2908,824,2084,1866
pisco,FALSE,4993258,2732,634,2098,1683
calks,FALSE,4992747,2825,705,2120,1765
unrig,FALSE,4992654,2791,482,2309,1636.5
aiyee,FALSE,4992639,3029,1114,1915,2071.5
winey,FALSE,4992598,2864,1106,1758,1985
feods,FALSE,4992363,2924,727,2197,1825.5
yechs,FALSE,4992062,2918,368,2550,1643
herby,FALSE,4991980,2956,862,2094,1909
gnash,TRUE,4991961,2756,819,1937,1787.5
skint,FALSE,4991950,2684,1077,1607,1880.5
plume,TRUE,4991769,2805,1000,1805,1902.5
swaly,FALSE,4991626,2786,1243,1543,2014.5
burin,FALSE,4991346,2758,810,1948,1784
forty,TRUE,4991318,2801,1081,1720,1941
evict,TRUE,4991004,2967,758,2209,1862.5
fides,FALSE,4990759,2898,767,2131,1832.5
jasey,FALSE,4990622,3027,1086,1941,2056.5
inane,TRUE,4990402.5,3162,1034,2128,2098
shuln,FALSE,4990146,2652,967,1685,1809.5
miche,FALSE,4990001,2828,817,2011,1822.5
laxed,FALSE,4989630,3020,840,2180,1930
frags,FALSE,4989378,2871,822,2049,1846.5
caved,FALSE,4989098,2932,987,1945,1959.5
ileal,FALSE,4989043.5,3260,731,2529,1995.5
sonse,FALSE,4989029.5,2897,1379,1518,2138
cavil,TRUE,4988950,2801,865,1936,1833
teugh,FALSE,4988804,2859,771,2088,1815
vices,FALSE,4988632,2918,655,2263,1786.5
typed,FALSE,4988478,2856,666,2190,1761
pokes,FALSE,4988226,2895,787,2108,1841
waive,TRUE,4988147,2955,1123,1832,2039
amids,FALSE,4987947,2842,550,2292,1696
solum,FALSE,4987892,2694,881,1813,1787.5
brawl,TRUE,4987889,2855,928,1927,1891.5
rille,FALSE,4987755,3188,1005,2183,2096.5
umrah,FALSE,4987748,2880,536,2344,1708
plebs,FALSE,4987738,2935,580,2355,1757.5
gibes,FALSE,4987533,2888,728,2160,1808
parvo,FALSE,4987372,2914,713,2201,1813.5
ahing,FALSE,4987313,2785,774,2011,1779.5
hikes,FALSE,4987212,2902,637,2265,1769.5
sheik,TRUE,4986990,2902,958,1944,1930
tufas,FALSE,4986166,2858,559,2299,1708.5
nutsy,FALSE,4986116,2709,869,1840,1789
mends,FALSE,4985991,2892,593,2299,1742.5
kilos,FALSE,4985976,2788,502,2286,1645
badge,TRUE,4985823,2902,1052,1850,1977
loved,FALSE,4985696,2896,852,2044,1874
grews,FALSE,4985535,3005,620,2385,1812.5
yawed,FALSE,4985322,2946,772,2174,1859
derby,TRUE,4985245,2947,904,2043,1925.5
lazed,FALSE,4985108,3018,839,2179,1928.5
grapy,FALSE,4984751,2809,1103,1706,1956
froth,TRUE,4984742,2763,925,1838,1844
iller,FALSE,4984684.5,3188,877,2311,2032.5
azide,FALSE,4984641,3017,902,2115,1959.5
dhoti,FALSE,4984525,2736,649,2087,1692.5
mohrs,FALSE,4984473,2805,583,2222,1694
salix,FALSE,4984176,2859,948,1911,1903.5
wield,TRUE,4983194,2915,742,2173,1828.5
bland,TRUE,4983121,2744,981,1763,1862.5
devot,FALSE,4982961,2915,787,2128,1851
grind,TRUE,4982705,2704,948,1756,1826
arede,FALSE,4982669.5,3172,1078,2094,2125
cruds,FALSE,4982595,2730,735,1995,1732.5
dwine,FALSE,4982213,2817,1027,1790,1922
kilts,FALSE,4982106,2782,509,2273,1645.5
duroy,FALSE,4982095,2754,956,1798,1855
lifts,FALSE,4981794,2787,490,2297,1638.5
hoped,FALSE,4981678,2824,842,1982,1833
patch,TRUE,4981660,2749,848,1901,1798.5
mardy,FALSE,4981602,2831,1007,1824,1919
briny,TRUE,4981380,2718,1252,1466,1985
curny,FALSE,4980860,2709,1093,1616,1901
pervs,FALSE,4980852,3006,629,2377,1817.5
dikes,FALSE,4980477,2893,679,2214,1786
gouts,FALSE,4980359,2715,734,1981,1724.5
beamy,FALSE,4979902,2947,1154,1793,2050.5
kuias,FALSE,4979870,2833,671,2162,1752
dupes,FALSE,4979775,2847,709,2138,1778
welsh,TRUE,4979714,2895,747,2148,1821
gurns,FALSE,4979659,2762,682,2080,1722
tipsy,TRUE,4979403,2695,944,1751,1819.5
extol,TRUE,4979338,3081,485,2596,1783
pumie,FALSE,4979207,2804,971,1833,1887.5
bunia,FALSE,4979061,2830,720,2110,1775
binge,TRUE,4979039,2820,1014,1806,1917
paper,TRUE,4978957,3148,1034,2114,2091
snift,FALSE,4978885,2689,1007,1682,1848
geare,FALSE,4978804,3102,1240,1862,2171
chays,FALSE,4978774,2771,688,2083,1729.5
uncos,FALSE,4978673,2746,344,2402,1545
sprog,FALSE,4978182,2774,763,2011,1768.5
cubes,FALSE,4978100,2846,795,2051,1820.5
crypt,TRUE,4977942,2715,797,1918,1756
flory,FALSE,4977781,2782,1097,1685,1939.5
ymolt,FALSE,4977526,2703,703,2000,1703
boche,FALSE,4977482,2823,960,1863,1891.5
tsked,FALSE,4977456,2913,613,2300,1763
dozer,FALSE,4977229,2971,931,2040,1951
voema,FALSE,4976211,3085,631,2454,1858
pulis,FALSE,4976158,2716,634,2082,1675
pohed,FALSE,4975882,2824,866,1958,1845
agree,TRUE,4975739,3102,1058,2044,2080
mount,TRUE,4975465,2645,986,1659,1815.5
balds,FALSE,4975417,2812,694,2118,1753
bloke,TRUE,4975266,2846,1097,1749,1971.5
vawte,FALSE,4975188,2975,936,2039,1955.5
scree,TRUE,4975155,2959,1311,1648,2135
gyron,FALSE,4975079,2777,563,2214,1670
yangs,FALSE,4975007,2794,561,2233,1677.5
linch,FALSE,4974973,2672,720,1952,1696
swarm,TRUE,4974944,2856,911,1945,1883.5
muled,FALSE,4974837,2829,841,1988,1835
meare,FALSE,4974532,3100,1232,1868,2166
vilde,FALSE,4974517,2870,850,2020,1860
quart,TRUE,4973976,2899,921,1978,1910
decaf,FALSE,4973973,2990,598,2392,1794
vespa,FALSE,4973778,3078,479,2599,1778.5
musit,FALSE,4973217,2687,784,1903,1735.5
lamps,FALSE,4972765,2819,539,2280,1679
puker,FALSE,4972634,2898,870,2028,1884
puton,FALSE,4972514,2693,701,1992,1697
wilts,FALSE,4972327,2774,572,2202,1673
buist,FALSE,4972273,2656,1049,1607,1852.5
rorie,FALSE,4972239,3213,1129,2084,2171
pricy,FALSE,4972226,2695,1191,1504,1943
brods,FALSE,4972213,2765,789,1976,1777
kohen,FALSE,4972070,2860,756,2104,1808
swayl,FALSE,4971596,2786,876,1910,1831
layup,FALSE,4971558,2777,559,2218,1668
umbre,FALSE,4971508,2915,704,2211,1809.5
hurly,FALSE,4971300,2738,944,1794,1841
prigs,FALSE,4971282,2748,787,1961,1767.5
flash,TRUE,4971230,2761,954,1807,1857.5
fakes,FALSE,4970978,2992,806,2186,1899
drusy,FALSE,4970902,2699,1078,1621,1888.5
acidy,FALSE,4970797,2791,880,1911,1835.5
hydra,FALSE,4970777,2912,383,2529,1647.5
chons,FALSE,4970666,2668,804,1864,1736
logic,TRUE,4970400,2716,623,2093,1669.5
crows,FALSE,4970331,2770,770,2000,1770
stonk,FALSE,4969975,2710,982,1728,1846
besom,FALSE,4969652,2912,669,2243,1790.5
poynt,FALSE,4969636,2653,885,1768,1769
rozit,FALSE,4969418,2859,806,2053,1832.5
bunce,FALSE,4969349,2778,1074,1704,1926
nomad,TRUE,4969284,2800,658,2142,1729
fours,FALSE,4969194,2792,768,2024,1780
pilus,FALSE,4969130,2716,574,2142,1645
genom,FALSE,4968442,2877,670,2207,1773.5
panim,FALSE,4968371,2750,785,1965,1767.5
blude,FALSE,4968318,2798,1032,1766,1915
roosa,FALSE,4967781,3037,863,2174,1950
fasci,FALSE,4967372,2829,683,2146,1756
lexis,FALSE,4966730,3006,536,2470,1771
umber,FALSE,4966604,2915,658,2257,1786.5
daiko,FALSE,4966562,2801,794,2007,1797.5
anigh,FALSE,4966543,2785,709,2076,1747
prims,FALSE,4966464,2746,779,1967,1762.5
touze,FALSE,4966248,2888,1037,1851,1962.5
slink,TRUE,4966192,2665,1128,1537,1896.5
thuya,FALSE,4966110,2829,525,2304,1677
wides,FALSE,4965434,2885,714,2171,1799.5
ovist,FALSE,4965405,2754,746,2008,1750
yelks,FALSE,4965281,2941,451,2490,1696
hefts,FALSE,4964838,2927,511,2416,1719
nicht,FALSE,4964715,2691,576,2115,1633.5
drift,TRUE,4964551,2728,932,1796,1830
deawy,FALSE,4964216,2946,1049,1897,1997.5
pimas,FALSE,4964201,2818,604,2214,1711
saros,FALSE,4964054,3037,1001,2036,2019
fleys,FALSE,4963568,2946,553,2393,1749.5
xeric,FALSE,4963527,3025,594,2431,1809.5
yauds,FALSE,4963309,2771,580,2191,1675.5
bevor,FALSE,4963268,2982,808,2174,1895
pyots,FALSE,4962818,2721,584,2137,1652.5
luged,FALSE,4962693,2831,777,2054,1804
mouls,FALSE,4962427,2694,749,1945,1721.5
simul,FALSE,4962411,2668,867,1801,1767.5
sairs,FALSE,4962376,3011,1124,1887,2067.5
enate,FALSE,4962307,3182,1029,2153,2105.5
prong,TRUE,4962105,2706,876,1830,1791
bowet,FALSE,4962058,2857,1049,1808,1953
swath,TRUE,4961632,2767,995,1772,1881
borak,FALSE,4961553,2888,891,1997,1889.5
grips,FALSE,4961365,2748,734,2014,1741
thyme,TRUE,4960878,2817,814,2003,1815.5
homey,FALSE,4960595,2823,1091,1732,1957
gebur,FALSE,4960495,2917,708,2209,1812.5
klieg,FALSE,4960378,2853,846,2007,1849.5
kutas,FALSE,4960260,2853,516,2337,1684.5
bunas,FALSE,4959819,2801,697,2104,1749
cronk,FALSE,4959543,2710,1004,1706,1857
wroth,FALSE,4959417,2750,872,1878,1811
talar,FALSE,4959078,3061,940,2121,2000.5
milpa,FALSE,4959045,2848,535,2313,1691.5
dogey,FALSE,4958448,2816,1139,1677,1977.5
sprig,TRUE,4958162,2748,789,1959,1768.5
yarer,FALSE,4958124,3219,1003,2216,2111
kreng,FALSE,4957674,2945,687,2258,1816
treen,FALSE,4957645.5,3110,1041,2069,2075.5
prize,TRUE,4957632,2921,1119,1802,2020
vocal,TRUE,4957272,2827,697,2130,1762
epoch,TRUE,4957265,2902,668,2234,1785
clogs,FALSE,4956943,2687,755,1932,1721
favel,FALSE,4956776,2969,963,2006,1966
zones,FALSE,4956653,2932,775,2157,1853.5
fined,FALSE,4956551,2830,913,1917,1871.5
vatic,FALSE,4955999,2820,647,2173,1733.5
frith,FALSE,4955542,2737,947,1790,1842
sneck,FALSE,4955387,2874,895,1979,1884.5
spang,FALSE,4955350,2723,957,1766,1840
zoril,FALSE,4955262,2840,759,2081,1799.5
sulfa,FALSE,4955248,2839,763,2076,1801
quair,FALSE,4954856,2879,886,1993,1882.5
reran,FALSE,4954811,3352,803,2549,2077.5
lacks,FALSE,4954447,2825,539,2286,1682
dhols,FALSE,4954371,2688,697,1991,1692.5
rubin,FALSE,4954052,2758,636,2122,1697
culpa,FALSE,4953884,2808,610,2198,1709
chord,TRUE,4953834,2707,856,1851,1781.5
terce,FALSE,4953709,3008,1130,1878,2069
stulm,FALSE,4953676,2688,812,1876,1750
gorps,FALSE,4953487,2774,643,2131,1708.5
swoln,FALSE,4953092,2683,946,1737,1814.5
doeks,FALSE,4953087,2919,658,2261,1788.5
syped,FALSE,4953058,2807,883,1924,1845
mebos,FALSE,4952957,2912,574,2338,1743
hangi,FALSE,4952703,2785,599,2186,1692
trant,FALSE,4952650,2963,1158,1805,2060.5
rynds,FALSE,4952470,2792,372,2420,1582
corks,FALSE,4952465,2778,731,2047,1754.5
ploys,FALSE,4952453,2702,626,2076,1664
nukes,FALSE,4952235,2883,589,2294,1736
grufe,FALSE,4952185,2857,1006,1851,1931.5
girds,FALSE,4951926,2772,585,2187,1678.5
sokah,FALSE,4951832,2781,959,1822,1870
empts,FALSE,4951582,2985,343,2642,1664
pioys,FALSE,4951476,2701,627,2074,1664
dench,FALSE,4951282,2803,783,2020,1793
jeton,FALSE,4951168,2973,635,2338,1804
spume,FALSE,4951101,2775,1084,1691,1929.5
punto,FALSE,4950977,2693,664,2029,1678.5
oncus,FALSE,4949931,2746,302,2444,1524
oubit,FALSE,4949692,2711,695,2016,1703
brond,FALSE,4949208,2697,984,1713,1840.5
taxis,FALSE,4949114,2878,659,2219,1768.5
foins,FALSE,4948970,2695,899,1796,1797
lapje,FALSE,4948746,2986,876,2110,1931
anear,FALSE,4948329,3352,780,2572,2066
tubed,FALSE,4948270,2817,828,1989,1822.5
bowie,FALSE,4947842,2837,1060,1777,1948.5
forth,TRUE,4947664,2763,856,1907,1809.5
tacet,FALSE,4947310,3080,1080,2000,2080
cibol,FALSE,4947234,2683,745,1938,1714
farcy,FALSE,4947100,2818,1119,1699,1968.5
shako,FALSE,4947077,2781,930,1851,1855.5
chout,FALSE,4947056,2624,921,1703,1772.5
motus,FALSE,4946981,2713,615,2098,1664
racer,TRUE,4946696,3250,995,2255,2122.5
hawed,FALSE,4946524,2908,835,2073,1871.5
quote,TRUE,4945766,2882,1016,1866,1949
wakes,FALSE,4945653,2979,753,2226,1866
peaky,FALSE,4945271,2930,1110,1820,2020
glams,FALSE,4945110,2773,727,2046,1750
donga,FALSE,4944928,2802,669,2133,1735.5
doree,FALSE,4944832,2936,1295,1641,2115.5
unsew,FALSE,4944586,2875,535,2340,1705
swept,TRUE,4944171,2881,890,1991,1885.5
shawl,TRUE,4944097,2748,998,1750,1873
saris,FALSE,4944034,3011,1027,1984,2019
blued,FALSE,4944001,2798,975,1823,1886.5
cloze,FALSE,4943293,2860,1087,1773,1973.5
vegas,FALSE,4943245,3032,551,2481,1791.5
whort,FALSE,4943177,2750,876,1874,1813
video,TRUE,4943077,2895,696,2199,1795.5
curds,FALSE,4942493,2730,652,2078,1691
reame,FALSE,4942475,3100,1146,1954,2123
pikes,FALSE,4942320,2869,710,2159,1789.5
limpa,FALSE,4942313,2848,465,2383,1656.5
jures,FALSE,4942262,2995,723,2272,1859
korus,FALSE,4941960,2787,580,2207,1683.5
defis,FALSE,4941953,2898,572,2326,1735
leugh,FALSE,4941902,2840,710,2130,1775
cowan,FALSE,4941752,2774,796,1978,1785
kaury,FALSE,4941690,2822,1005,1817,1913.5
maize,TRUE,4941591,2945,1121,1824,2033
chins,FALSE,4941466,2642,826,1816,1734
flays,FALSE,4941349,2799,683,2116,1741
farms,FALSE,4941338,2869,707,2162,1788
kayos,FALSE,4941334,2819,521,2298,1670
volti,FALSE,4941332,2784,584,2200,1684
korma,FALSE,4941246,2919,594,2325,1756.5
berks,FALSE,4941127,2980,669,2311,1824.5
graph,TRUE,4941097,2771,878,1893,1824.5
dreck,FALSE,4941053,2913,820,2093,1866.5
skald,FALSE,4940926,2747,963,1784,1855
stink,TRUE,4940775,2684,1004,1680,1844
dribs,FALSE,4940563,2739,704,2035,1721.5
soras,FALSE,4940246,3037,1007,2030,2022
amigo,FALSE,4940090,2827,579,2248,1703
purty,FALSE,4940068,2724,994,1730,1859
jiaos,FALSE,4940046,2874,697,2177,1785.5
ghaut,FALSE,4940041,2712,901,1811,1806.5
lived,FALSE,4939790,2870,775,2095,1822.5
caese,FALSE,4939705.5,3031,1274,1757,2152.5
kulas,FALSE,4939576,2834,517,2317,1675.5
byrls,FALSE,4939200,2787,557,2230,1672
jones,FALSE,4938673,2924,792,2132,1858
proud,TRUE,4938502,2683,853,1830,1768
veldt,FALSE,4938409,2890,719,2171,1804.5
mandi,FALSE,4937967,2774,630,2144,1702
couth,FALSE,4937906,2624,920,1704,1772
sadhu,FALSE,4937861,2733,774,1959,1753.5
weids,FALSE,4937838,2885,696,2189,1790.5
shiny,TRUE,4937588,2611,1322,1289,1966.5
trunk,TRUE,4937569,2713,876,1837,1794.5
piony,FALSE,4937554,2633,1134,1499,1883.5
frosh,FALSE,4937317,2714,957,1757,1835.5
touch,TRUE,4937188,2624,884,1740,1754
nubia,FALSE,4936621,2830,502,2328,1666
ponty,FALSE,4936479,2653,1063,1590,1858
stown,FALSE,4936415,2702,842,1860,1772
glaze,TRUE,4936278,2948,1067,1881,2007.5
hangs,FALSE,4936209,2756,624,2132,1690
kyats,FALSE,4936168,2813,525,2288,1669
mudra,FALSE,4936130,2871,584,2287,1727.5
imago,FALSE,4936112,2827,513,2314,1670
yclad,FALSE,4935954,2792,439,2353,1615.5
cymes,FALSE,4935853,2837,636,2201,1736.5
krang,FALSE,4935455,2798,817,1981,1807.5
gluts,FALSE,4935430,2690,656,2034,1673
bords,FALSE,4935135,2765,720,2045,1742.5
toque,FALSE,4935040,2882,935,1947,1908.5
marks,FALSE,4935034,2864,665,2199,1764.5
turfs,FALSE,4934932,2786,569,2217,1677.5
cozie,FALSE,4934902,2859,1070,1789,1964.5
viols,FALSE,4934766,2735,687,2048,1711
nowed,FALSE,4934139,2843,778,2065,1810.5
damns,FALSE,4933320,2745,694,2051,1719.5
snack,TRUE,4933168,2727,1025,1702,1876
jails,FALSE,4933078,2849,788,2061,1818.5
roupy,FALSE,4933056,2730,963,1767,1846.5
dorbs,FALSE,4932685,2765,613,2152,1689
senas,FALSE,4932677,3133,946,2187,2039.5
rungs,FALSE,4932559,2762,542,2220,1652
clavi,FALSE,4932511,2801,763,2038,1782
ghost,TRUE,4932242,2637,927,1710,1782
hoves,FALSE,4931646,2875,751,2124,1813
scrow,FALSE,4931623,2770,718,2052,1744
probs,FALSE,4931606,2741,713,2028,1727
caums,FALSE,4931580,2730,771,1959,1750.5
kipes,FALSE,4931416,2869,634,2235,1751.5
wined,FALSE,4931226,2817,860,1957,1838.5
fonts,FALSE,4931189,2715,729,1986,1722
hazes,FALSE,4931058,2997,738,2259,1867.5
jatos,FALSE,4930998,2894,603,2291,1748.5
joule,FALSE,4930614,2861,1050,1811,1955.5
glove,TRUE,4930524,2826,1030,1796,1928
dancy,FALSE,4930418,2694,1070,1624,1882
gusto,TRUE,4930417,2715,578,2137,1646.5
muils,FALSE,4930203,2668,757,1911,1712.5
phots,FALSE,4929874,2683,705,1978,1694
dangs,FALSE,4929474,2747,666,2081,1706.5
zatis,FALSE,4928958,2876,612,2264,1744
kraft,FALSE,4928944,2822,882,1940,1852
vauts,FALSE,4928858,2800,687,2113,1743.5
teade,FALSE,4928640,3002,1191,1811,2096.5
coign,FALSE,4928324,2618,949,1669,1783.5
vaunt,TRUE,4928236,2732,947,1785,1839.5
polys,FALSE,4927888,2702,572,2130,1637
stogy,FALSE,4927648,2675,1127,1548,1901
bends,FALSE,4927566,2861,659,2202,1760
parae,FALSE,4927508,3148,1196,1952,2172
turks,FALSE,4927467,2781,589,2192,1685
fraud,TRUE,4927398,2780,910,1870,1845
stars,FALSE,4927374,3031,938,2093,1984.5
delfs,FALSE,4927213,2899,536,2363,1717.5
donsy,FALSE,4927211,2628,1064,1564,1846
candy,TRUE,4926946,2694,1074,1620,1884
germy,FALSE,4926679,2908,952,1956,1930
aurae,FALSE,4926557,3259,1077,2182,2168
easel,TRUE,4926517,3231,930,2301,2080.5
chads,FALSE,4926485,2724,754,1970,1739
mused,FALSE,4926375,2799,809,1990,1804
garum,FALSE,4926371,2801,706,2095,1753.5
kerbs,FALSE,4926252,2980,485,2495,1732.5
crown,TRUE,4925983,2702,864,1838,1783
umpie,FALSE,4925952,2804,711,2093,1757.5
leone,FALSE,4925919,2927,1180,1747,2053.5
mowra,FALSE,4925677,2911,628,2283,1769.5
wrang,FALSE,4925676,2790,880,1910,1835
mucor,FALSE,4925447,2713,693,2020,1703
khets,FALSE,4925443,2922,516,2406,1719
three,TRUE,4925423,2939,1198,1741,2068.5
myope,FALSE,4925319,2790,848,1942,1819
doves,FALSE,4924911,2866,793,2073,1829.5
volts,FALSE,4924838,2755,609,2146,1682
hunts,FALSE,4924831,2671,569,2102,1620
taxon,FALSE,4924786,2836,727,2109,1781.5
axled,FALSE,4924772,3020,703,2317,1861.5
hauds,FALSE,4924511,2733,643,2090,1688
dazes,FALSE,4924323,2988,780,2208,1884
reest,FALSE,4924170.5,3178,948,2230,2063
kefir,FALSE,4923908,2949,657,2292,1803
tonks,FALSE,4923878,2710,658,2052,1684
noxes,FALSE,4923195,2934,682,2252,1808
bardy,FALSE,4923177,2800,1073,1727,1936.5
being,TRUE,4922957,2820,904,1916,1862
brews,FALSE,4922838,2972,678,2294,1825
sloes,FALSE,4922647,2995,1165,1830,2080
shady,TRUE,4922607,2693,1250,1443,1971.5
worth,TRUE,4922339,2750,803,1947,1776.5
swapt,FALSE,4921952,2734,1020,1714,1877
wipes,FALSE,4921637,2861,697,2164,1779
hynde,FALSE,4921432,2772,724,2048,1748
furls,FALSE,4921118,2767,683,2084,1725
widen,TRUE,4921086,2817,808,2009,1812.5
typos,FALSE,4921080,2721,398,2323,1559.5
porch,TRUE,4920694,2683,875,1808,1779
equal,TRUE,4920672,3099,561,2538,1830
spelk,FALSE,4920555,2870,879,1991,1874.5
frabs,FALSE,4920502,2838,770,2068,1804
holds,FALSE,4920491,2688,565,2123,1626.5
pogey,FALSE,4920291,2792,1170,1622,1981
unlid,FALSE,4920221,2672,508,2164,1590
braks,FALSE,4919831,2833,838,1995,1835.5
tways,FALSE,4919746,2805,539,2266,1672
mynas,FALSE,4919260,2792,468,2324,1630
bitou,FALSE,4919136,2711,619,2092,1665
tophi,FALSE,4919132,2712,525,2187,1618.5
slimy,TRUE,4919047,2628,1265,1363,1946.5
incus,FALSE,4918991,2720,295,2425,1507.5
yaups,FALSE,4918964,2747,561,2186,1654
drack,FALSE,4918834,2766,950,1816,1858
aping,TRUE,4918388,2752,691,2061,1721.5
gager,FALSE,4918249,3102,1016,2086,2059
neuks,FALSE,4918118,2883,535,2348,1709
dunts,FALSE,4918096,2662,611,2051,1636.5
movie,TRUE,4918059,2823,1017,1806,1920
smorg,FALSE,4917991,2726,841,1885,1783.5
savoy,TRUE,4917822,2766,1215,1551,1990.5
lazos,FALSE,4917710,2883,571,2312,1727
bouts,FALSE,4917662,2682,792,1890,1737
knawe,FALSE,4917536,2911,863,2048,1887
debut,TRUE,4917491,2817,745,2072,1781
churn,TRUE,4917342,2671,789,1882,1730
burns,FALSE,4916962,2729,740,1989,1734.5
start,TRUE,4916752,3031,1155,1876,2093
mausy,FALSE,4916704,2699,1111,1588,1905
bowse,FALSE,4916567,2808,1073,1735,1940.5
quite,TRUE,4916566,2856,1038,1818,1947
ambit,FALSE,4916490,2788,647,2141,1717.5
vogie,FALSE,4916325,2825,971,1854,1898
beare,FALSE,4916107,3069,1298,1771,2183.5
tweak,TRUE,4916094,3028,646,2382,1837
warms,FALSE,4916013,2856,654,2202,1755
devil,TRUE,4915951,2870,716,2154,1793
whets,FALSE,4915664,2914,579,2335,1746.5
calmy,FALSE,4915602,2720,1046,1674,1883
fiord,FALSE,4915432,2734,852,1882,1793
bowel,TRUE,4915068,2838,952,1886,1895
dread,TRUE,4915027.5,3172,836,2336,2004
foehn,FALSE,4915013,2865,750,2115,1807.5
towns,FALSE,4914656,2702,672,2030,1687
quiet,TRUE,4914632,2856,1046,1810,1951
thews,FALSE,4914466,2914,531,2383,1722.5
milty,FALSE,4914203,2677,924,1753,1800.5
tunds,FALSE,4913906,2662,579,2083,1620.5
camus,FALSE,4912967,2730,681,2049,1705.5
hajes,FALSE,4912842,2989,730,2259,1859.5
fauns,FALSE,4912696,2741,823,1918,1782
darer,FALSE,4912591,3172,1108,2064,2140
depth,TRUE,4912581,2818,689,2129,1753.5
uplay,FALSE,4912415,2777,733,2044,1755
lowry,FALSE,4912294,2769,909,1860,1839
jurat,FALSE,4911986,2897,785,2112,1841
tanky,FALSE,4911920,2745,1011,1734,1878
sambo,FALSE,4911859,2765,813,1952,1789
agism,FALSE,4911841,2772,632,2140,1702
skelp,FALSE,4911273,2870,771,2099,1820.5
stele,FALSE,4911204.5,2989,1206,1783,2097.5
pokal,FALSE,4910960,2778,752,2026,1765
zines,FALSE,4910747,2906,698,2208,1802
tasar,FALSE,4910616,3031,908,2123,1969.5
fomes,FALSE,4910413,2852,830,2022,1841
admin,TRUE,4910323,2774,510,2264,1642
romps,FALSE,4910233,2772,531,2241,1651.5
mawrs,FALSE,4910223,2856,625,2231,1740.5
flout,TRUE,4909631,2652,916,1736,1784
mopey,FALSE,4909419,2790,1126,1664,1958
jaspe,FALSE,4909222,2956,878,2078,1917
synth,FALSE,4909097,2631,806,1825,1718.5
culty,FALSE,4909042,2637,999,1638,1818
noose,TRUE,4908904,2897,1155,1742,2026
lupin,FALSE,4908794,2648,620,2028,1634
woads,FALSE,4908664,2764,774,1990,1769
fagot,FALSE,4908533,2756,892,1864,1824
pechs,FALSE,4908372,2847,504,2343,1675.5
seine,FALSE,4908201,2871,1480,1391,2175.5
mutis,FALSE,4908103,2687,598,2089,1642.5
exits,FALSE,4907808,3025,527,2498,1776
jarul,FALSE,4907662,2878,725,2153,1801.5
rifty,FALSE,4907304,2775,835,1940,1805
glume,FALSE,4907302,2759,973,1786,1866
xerus,FALSE,4907280,3005,523,2482,1764
jotas,FALSE,4907190,2894,609,2285,1751.5
udons,FALSE,4906914,2668,515,2153,1591.5
sella,FALSE,4906855,3231,946,2285,2088.5
snafu,FALSE,4906815,2741,796,1945,1768.5
ponga,FALSE,4906771,2778,700,2078,1739
could,TRUE,4906528,2596,922,1674,1759
metif,FALSE,4906447,2875,644,2231,1759.5
kehua,FALSE,4906022,3003,417,2586,1710
furca,FALSE,4906014,2858,701,2157,1779.5
wonts,FALSE,4905864,2702,676,2026,1689
mauve,TRUE,4905707,2869,1046,1823,1957.5
hiree,FALSE,4905661,2919,1176,1743,2047.5
cheka,FALSE,4905632,2994,638,2356,1816
jeons,FALSE,4905574,2924,724,2200,1824
anent,FALSE,4905411.5,3182,840,2342,2011
sumac,TRUE,4905008,2730,807,1923,1768.5
krabs,FALSE,4904956,2833,654,2179,1743.5
ratal,FALSE,4904692,3061,839,2222,1950
waldo,FALSE,4904064,2794,626,2168,1710
barbe,FALSE,4903624,3069,1088,1981,2078.5
umiac,FALSE,4903581,2759,531,2228,1645
khats,FALSE,4903224,2775,646,2129,1710.5
kuris,FALSE,4903082,2761,563,2198,1662
hemic,FALSE,4902950,2828,561,2267,1694.5
tawny,TRUE,4902698,2737,1025,1712,1881
tophs,FALSE,4902638,2683,550,2133,1616.5
haiks,FALSE,4902259,2755,730,2025,1742.5
sclim,FALSE,4902238,2659,718,1941,1688.5
newly,TRUE,4901771,2865,831,2034,1848
firth,FALSE,4901758,2737,779,1958,1758
vised,FALSE,4901738,2840,761,2079,1800.5
pawed,FALSE,4901632,2875,908,1967,1891.5
visto,FALSE,4901508,2754,522,2232,1638
lubed,FALSE,4901368,2798,767,2031,1782.5
waken,FALSE,4901305,2911,847,2064,1879
phoca,FALSE,4901110,2755,746,2009,1750.5
waxer,FALSE,4901021,3033,929,2104,1981
gudes,FALSE,4900948,2801,730,2071,1765.5
sedum,FALSE,4900919,2799,807,1992,1803
braws,FALSE,4900619,2825,808,2017,1816.5
whaur,FALSE,4900581,2776,828,1948,1802
barfi,FALSE,4900568,2867,686,2181,1776.5
yawls,FALSE,4900394,2786,534,2252,1660
hafts,FALSE,4900320,2780,573,2207,1676.5
plods,FALSE,4900164,2655,692,1963,1673.5
vatus,FALSE,4899752,2800,576,2224,1688
jades,FALSE,4899551,2980,753,2227,1866.5
mokes,FALSE,4899487,2847,752,2095,1799.5
homed,FALSE,4899223,2776,845,1931,1810.5
vegan,TRUE,4898897,2964,645,2319,1804.5
davit,FALSE,4898423,2742,875,1867,1808.5
soles,FALSE,4898082,2995,1111,1884,2053
korun,FALSE,4897612,2719,674,2045,1696.5
pudor,FALSE,4897593,2683,747,1936,1715
welds,FALSE,4897544,2886,542,2344,1714
adunc,FALSE,4897347,2734,539,2195,1636.5
takhi,FALSE,4897242,2804,504,2300,1654
gatch,FALSE,4897193,2703,821,1882,1762
demic,FALSE,4896215,2819,603,2216,1711
whorl,FALSE,4896187,2731,779,1952,1755
nodus,FALSE,4896052,2668,509,2159,1588.5
chemo,FALSE,4896029,2854,645,2209,1749.5
fados,FALSE,4895937,2777,683,2094,1730
faurd,FALSE,4895864,2780,875,1905,1827.5
choke,TRUE,4895625,2758,1065,1693,1911.5
medic,TRUE,4895571,2819,613,2206,1716
readd,FALSE,4895493.5,3172,841,2331,2006.5
synod,TRUE,4895249,2628,778,1850,1703
kulan,FALSE,4895228,2766,611,2155,1688.5
micos,FALSE,4895133,2684,533,2151,1608.5
truer,TRUE,4895086,3017,1111,1906,2064
cloud,TRUE,4894963,2596,843,1753,1719.5
gluon,FALSE,4894952,2628,743,1885,1685.5
fumer,FALSE,4894821,2855,913,1942,1884
chark,FALSE,4894457,2775,914,1861,1844.5
boyed,FALSE,4894362,2783,917,1866,1850
zeins,FALSE,4894354,2906,729,2177,1817.5
bouge,FALSE,4894352,2753,1117,1636,1935
ofays,FALSE,4894200,2824,395,2429,1609.5
blocs,FALSE,4893989,2654,806,1848,1730
wanty,FALSE,4893906,2737,1029,1708,1883
pharm,FALSE,4893718,2769,787,1982,1778
stimy,FALSE,4893630,2647,1141,1506,1894
knots,FALSE,4893545,2710,526,2184,1618
whats,FALSE,4893445,2767,709,2058,1738
pucan,FALSE,4893124,2710,677,2033,1693.5
mikra,FALSE,4893035,2893,537,2356,1715
match,TRUE,4892921,2701,813,1888,1757
poind,FALSE,4892888,2586,987,1599,1786.5
input,TRUE,4892861,2667,514,2153,1590.5
pursy,FALSE,4892643,2675,1026,1649,1850.5
senna,FALSE,4892366.5,3133,993,2140,2063
smaze,FALSE,4892364,2916,1155,1761,2035.5
thaws,FALSE,4892247,2767,661,2106,1714
rocks,FALSE,4891915,2778,531,2247,1654.5
vower,FALSE,4891900,2909,878,2031,1893.5
unsod,FALSE,4891779,2668,450,2218,1559
begin,TRUE,4891489,2820,770,2050,1795
pangs,FALSE,4891317,2723,697,2026,1710
world,TRUE,4890961,2722,805,1917,1763.5
impro,FALSE,4890904,2801,340,2461,1570.5
befit,TRUE,4890892,2844,851,1993,1847.5
paxes,FALSE,4890688,2966,812,2154,1889
getup,FALSE,4890569,2826,606,2220,1716
owned,FALSE,4890505,2843,660,2183,1751.5
sente,FALSE,4890420,2891,1310,1581,2100.5
drear,FALSE,4890352,3172,930,2242,2051
runch,FALSE,4889849,2671,721,1950,1696
brank,FALSE,4889831,2765,1042,1723,1903.5
ledum,FALSE,4889437,2829,529,2300,1679
cling,TRUE,4889366,2593,888,1705,1740.5
tases,FALSE,4889351,3250,887,2363,2068.5
birds,FALSE,4889229,2739,643,2096,1691
finos,FALSE,4889153,2695,645,2050,1670
pelfs,FALSE,4889056,2875,567,2308,1721
courb,FALSE,4889032,2682,805,1877,1743.5
odyls,FALSE,4888992,2726,288,2438,1507
saugh,FALSE,4888866,2663,1050,1613,1856.5
rello,FALSE,4888425,3214,679,2535,1946.5
fluey,FALSE,4888307,2785,1184,1601,1984.5
sneer,TRUE,4888216.5,3061,1160,1901,2110.5
ogams,FALSE,4888206,2798,464,2334,1631
testa,FALSE,4887906,3250,674,2576,1962
crier,TRUE,4887860,2988,1261,1727,2124.5
eales,FALSE,4887709,3231,842,2389,2036.5
hypes,FALSE,4887526,2816,504,2312,1660
hoven,FALSE,4887298,2807,845,1962,1826
fiend,TRUE,4887297,2830,815,2015,1822.5
blags,FALSE,4887231,2742,793,1949,1767.5
riser,TRUE,4887226,3158,917,2241,2037.5
jaker,FALSE,4886770,3031,866,2165,1948.5
vague,TRUE,4886705,2871,920,1951,1895.5
podge,FALSE,4886005,2745,996,1749,1870.5
hives,FALSE,4885740,2849,674,2175,1761.5
reuse,TRUE,4885370,2968,1107,1861,2037.5
haulm,FALSE,4885160,2691,742,1949,1716.5
gamin,FALSE,4885080,2704,768,1936,1736
okays,FALSE,4884998,2819,397,2422,1608
fovea,FALSE,4884960,2994,846,2148,1920
haply,FALSE,4884792,2699,957,1742,1828
rowth,FALSE,4884492,2750,688,2062,1719
barfs,FALSE,4884074,2838,711,2127,1774.5
muton,FALSE,4883775,2645,666,1979,1655.5
bravo,TRUE,4883430,2835,851,1984,1843
baize,FALSE,4883166,2914,1187,1727,2050.5
kaids,FALSE,4883099,2746,695,2051,1720.5
pseud,FALSE,4882949,2847,535,2312,1691
clift,FALSE,4882855,2617,953,1664,1785
veiny,FALSE,4882810,2819,1097,1722,1958
heavy,TRUE,4882724,2910,1028,1882,1969
twins,FALSE,4882438,2676,677,1999,1676.5
blams,FALSE,4882413,2740,785,1955,1762.5
chaps,FALSE,4882140,2700,735,1965,1717.5
prowl,TRUE,4881927,2698,834,1864,1766
throw,TRUE,4881891,2750,605,2145,1677.5
tonne,FALSE,4881624.5,2946,1173,1773,2059.5
sleet,TRUE,4881620.5,2989,1315,1674,2152
melik,FALSE,4881584,2851,732,2119,1791.5
trets,FALSE,4881555,3178,768,2410,1973
thank,TRUE,4881459,2707,895,1812,1801
dipso,FALSE,4881382,2654,600,2054,1627
fetwa,FALSE,4881269,3033,578,2455,1805.5
hertz,FALSE,4881106,2974,617,2357,1795.5
kepis,FALSE,4881092,2869,514,2355,1691.5
roneo,FALSE,4880819,3116,899,2217,2007.5
terts,FALSE,4880632,3178,729,2449,1953.5
lurks,FALSE,4880565,2762,528,2234,1645
doven,FALSE,4880563,2798,887,1911,1842.5
wanly,FALSE,4880246,2718,1052,1666,1885
axils,FALSE,4880138,2859,619,2240,1739
gosht,FALSE,4880083,2637,755,1882,1696
punts,FALSE,4879939,2638,642,1996,1640
zonal,TRUE,4879387,2815,740,2075,1777.5
necks,FALSE,4879200,2874,426,2448,1650
sigma,TRUE,4879015,2772,767,2005,1769.5
dives,FALSE,4879005,2840,716,2124,1778
tense,TRUE,4878415,2891,1125,1766,2008
belch,TRUE,4878330,2798,818,1980,1808
delph,FALSE,4878317,2799,654,2145,1726.5
tinks,FALSE,4877972,2684,581,2103,1632.5
sight,TRUE,4877705,2611,916,1695,1763.5
lindy,FALSE,4877638,2632,862,1770,1747
crore,FALSE,4877624,3014,1285,1729,2149.5
laugh,TRUE,4877384,2693,772,1921,1732.5
nixes,FALSE,4877289,2908,605,2303,1756.5
cebid,FALSE,4877038,2788,773,2015,1780.5
barks,FALSE,4876609,2833,731,2102,1782
fiver,FALSE,4876506,2896,917,1979,1906.5
otter,TRUE,4876418,3233,759,2474,1996
quean,FALSE,4876033,3001,679,2322,1840
vrous,FALSE,4875864,2734,672,2062,1703
bogue,FALSE,4875509,2753,1025,1728,1889
hyleg,FALSE,4875217,2800,563,2237,1681.5
spawl,FALSE,4875172,2715,915,1800,1815
gravs,FALSE,4875089,2813,771,2042,1792
ungot,FALSE,4874676,2647,572,2075,1609.5
parer,TRUE,4874434,3148,1139,2009,2143.5
gorms,FALSE,4874119,2726,661,2065,1693.5
koaps,FALSE,4874098,2748,692,2056,1720
gonef,FALSE,4873896,2786,877,1909,1831.5
emong,FALSE,4873885,2877,577,2300,1727
suing,TRUE,4873877,2572,1041,1531,1806.5
warez,FALSE,4873721,3031,872,2159,1951.5
mango,TRUE,4873616,2730,684,2046,1707
kinos,FALSE,4873607,2690,529,2161,1609.5
blaze,TRUE,4873581,2915,1125,1790,2020
grize,FALSE,4873165,2875,1092,1783,1983.5
darre,FALSE,4873155,3172,1154,2018,2163
sites,FALSE,4872860,2988,1033,1955,2010.5
chirp,TRUE,4872762,2657,816,1841,1736.5
ochry,FALSE,4872752,2754,606,2148,1680
starr,FALSE,4872651,3031,1114,1917,2072.5
smith,TRUE,4872178,2609,948,1661,1778.5
blunt,TRUE,4872111,2589,974,1615,1781.5
monic,FALSE,4870175,2616,714,1902,1665
faves,FALSE,4869506,2939,843,2096,1891
halfs,FALSE,4869430,2761,556,2205,1658.5
fadge,FALSE,4868757,2842,1015,1827,1928.5
spiny,TRUE,4868663,2578,1239,1339,1908.5
hokas,FALSE,4868582,2781,559,2222,1670
dawts,FALSE,4868521,2758,616,2142,1687
teers,FALSE,4868385.5,3178,756,2422,1967
sties,FALSE,4868030,2988,1063,1925,2025.5
newsy,FALSE,4868006,2835,840,1995,1837.5
zoris,FALSE,4867992,2810,639,2171,1724.5
bused,TRUE,4867950,2768,875,1893,1821.5
bolus,FALSE,4867872,2663,682,1981,1672.5
moyls,FALSE,4867859,2654,613,2041,1633.5
noups,FALSE,4867781,2644,567,2077,1605.5
lowns,FALSE,4867754,2683,611,2072,1647
shirk,TRUE,4867193,2683,1041,1642,1862
ulzie,FALSE,4867155,2843,827,2016,1835
mengs,FALSE,4867096,2822,600,2222,1711
whirl,TRUE,4866987,2705,801,1904,1753
wadts,FALSE,4866742,2758,637,2121,1697.5
blech,FALSE,4866740,2798,842,1956,1820
combe,FALSE,4866551,2742,986,1756,1864
light,TRUE,4866223,2641,638,2003,1639.5
kendo,FALSE,4865992,2851,528,2323,1689.5
taras,FALSE,4865890,3031,815,2216,1923
syrup,TRUE,4865824,2675,690,1985,1682.5
toast,TRUE,4865823,2867,1159,1708,2013
misty,FALSE,4865741,2647,892,1755,1769.5
virtu,FALSE,4865496,2757,548,2209,1652.5
kelim,FALSE,4865482,2851,574,2277,1712.5
hoagy,FALSE,4865276,2678,1095,1583,1886.5
lanky,TRUE,4865018,2726,950,1776,1838
jural,FALSE,4864996,2878,688,2190,1783
hapus,FALSE,4864640,2709,549,2160,1629
vasty,FALSE,4864418,2760,930,1830,1845
knits,FALSE,4864345,2684,548,2136,1616
eaten,TRUE,4864045,3182,935,2247,2058.5
winos,FALSE,4863828,2682,592,2090,1637
pyric,FALSE,4863519,2695,517,2178,1606
fakir,FALSE,4863136,2802,822,1980,1812
bands,FALSE,4863048,2714,721,1993,1717.5
datum,TRUE,4862979,2701,650,2051,1675.5
kelps,FALSE,4862978,2870,460,2410,1665
bomas,FALSE,4862943,2765,712,2053,1738.5
nowts,FALSE,4862871,2702,517,2185,1609.5
gusli,FALSE,4862213,2670,554,2116,1612
undos,FALSE,4862080,2668,363,2305,1515.5
midst,TRUE,4861505,2600,808,1792,1704
mucro,FALSE,4861325,2713,559,2154,1636
slung,TRUE,4861172,2573,955,1618,1764
snaky,TRUE,4860546,2696,1179,1517,1937.5
yorks,FALSE,4860481,2747,539,2208,1643
kadis,FALSE,4860371,2746,593,2153,1669.5
pilaf,FALSE,4860290,2757,645,2112,1701
among,TRUE,4859875,2730,646,2084,1688
gwine,FALSE,4859589,2747,1031,1716,1889
rushy,FALSE,4859574,2708,763,1945,1735.5
kafir,FALSE,4859390,2802,719,2083,1760.5
sword,TRUE,4859386,2692,924,1768,1808
trats,FALSE,4859336,3031,898,2133,1964.5
caphs,FALSE,4859138,2700,624,2076,1662
begad,FALSE,4858719,2902,763,2139,1832.5
zilas,FALSE,4858580,2857,516,2341,1686.5
souse,FALSE,4858436.5,2804,1405,1399,2104.5
cuish,FALSE,4858257,2549,960,1589,1754.5
okehs,FALSE,4858081,2928,292,2636,1610
idyls,FALSE,4858052,2700,281,2419,1490.5
twerk,FALSE,4857648,2956,635,2321,1795.5
arena,TRUE,4857599,3352,831,2521,2091.5
paiks,FALSE,4857367,2722,803,1919,1762.5
notum,FALSE,4857329,2645,551,2094,1598
ryked,FALSE,4857154,2882,576,2306,1729
tetri,FALSE,4856636,3207,665,2542,1936
finca,FALSE,4856519,2761,693,2068,1727
dashy,FALSE,4856489,2693,887,1806,1790
brawn,TRUE,4856271,2757,902,1855,1829.5
lawny,FALSE,4855796,2718,964,1754,1841
japes,FALSE,4855754,2956,736,2220,1846
yogis,FALSE,4855191,2655,546,2109,1600.5
kbars,FALSE,4855070,2833,531,2302,1682
pouke,FALSE,4854903,2734,1065,1669,1899.5
pendu,FALSE,4854594,2779,593,2186,1686
bemad,FALSE,4854131,2900,757,2143,1828.5
bayou,TRUE,4853810,2723,639,2084,1681
inked,FALSE,4853749,2825,569,2256,1697
mikes,FALSE,4853581,2821,675,2146,1748
piths,FALSE,4853530,2657,519,2138,1588
aught,FALSE,4853495,2712,675,2037,1693.5
gambe,FALSE,4853392,2830,928,1902,1879
chasm,TRUE,4853369,2652,862,1790,1757
axion,TRUE,4853320,2816,683,2133,1749.5
brogs,FALSE,4853318,2695,796,1899,1745.5
aredd,FALSE,4852892.5,3172,772,2400,1972
pylon,FALSE,4852846,2634,539,2095,1586.5
lobus,FALSE,4852828,2663,542,2121,1602.5
askew,TRUE,4852497,2979,504,2475,1741.5
bicep,TRUE,4852234,2764,805,1959,1784.5
pyned,FALSE,4852223,2739,740,1999,1739.5
rores,FALSE,4852195,3184,901,2283,2042.5
siles,FALSE,4852176,2969,1034,1935,2001.5
antae,FALSE,4852060,3182,926,2256,2054
glaik,FALSE,4852047,2706,894,1812,1800
warbs,FALSE,4851955,2825,610,2215,1717.5
kohas,FALSE,4851882,2781,507,2274,1644
rappe,FALSE,4851859,3148,941,2207,2044.5
bawrs,FALSE,4851798,2825,691,2134,1758
balms,FALSE,4851704,2740,693,2047,1716.5
wiver,FALSE,4851181,2883,864,2019,1873.5
minke,FALSE,4850851,2753,927,1826,1840
plews,FALSE,4850789,2862,581,2281,1721.5
wadis,FALSE,4850592,2738,656,2082,1697
arame,FALSE,4850527,3100,1207,1893,2153.5
gryke,FALSE,4850152,2812,890,1922,1851
nidus,FALSE,4850146,2642,432,2210,1537
nudge,TRUE,4850014,2733,798,1935,1765.5
aarti,FALSE,4849818,3060,758,2302,1909
paysd,FALSE,4849503,2660,764,1896,1712
hyson,FALSE,4849276,2637,434,2203,1535.5
nowls,FALSE,4849211,2683,540,2143,1611.5
devos,FALSE,4848701,2866,570,2296,1718
debag,FALSE,4848448,2902,614,2288,1758
cukes,FALSE,4848420,2781,750,2031,1765.5
tress,FALSE,4848162.5,3178,800,2378,1989
moped,FALSE,4848047,2743,880,1863,1811.5
monty,FALSE,4847740,2605,1028,1577,1816.5
pekin,FALSE,4847648,2801,684,2117,1742.5
pease,FALSE,4847248,2929,1286,1643,2107.5
kilns,FALSE,4847224,2665,552,2113,1608.5
shrow,FALSE,4846471,2701,822,1879,1761.5
sonne,FALSE,4846204.5,2897,1390,1507,2143.5
shank,TRUE,4846039,2658,1112,1546,1885
ricks,FALSE,4846009,2752,454,2298,1603
ikons,FALSE,4845950,2690,506,2184,1598
bahut,FALSE,4845940,2679,821,1858,1750
noxal,FALSE,4845929,2817,647,2170,1732
youth,TRUE,4845922,2593,728,1865,1660.5
wekas,FALSE,4845635,2979,536,2443,1757.5
flaps,FALSE,4844715,2728,730,1998,1729
seils,FALSE,4844636,2969,1072,1897,2020.5
blume,FALSE,4844605,2726,1031,1695,1878.5
spayd,FALSE,4844599,2660,855,1805,1757.5
degus,FALSE,4844556,2801,538,2263,1669.5
ogive,FALSE,4844420,2825,789,2036,1807
miaow,FALSE,4844418,2721,765,1956,1743
waves,FALSE,4844181,2926,790,2136,1858
oases,FALSE,4843931,3256,779,2477,2017.5
coked,FALSE,4843588,2749,925,1824,1837
biach,FALSE,4843544,2650,973,1677,1811.5
wadge,FALSE,4843432,2829,962,1867,1895.5
redox,FALSE,4843209,2973,562,2411,1767.5
meows,FALSE,4843134,2839,654,2185,1746.5
nexts,FALSE,4843115,2928,466,2462,1697
lases,FALSE,4842449,3231,826,2405,2028.5
rhody,FALSE,4842449,2676,926,1750,1801
taals,FALSE,4842338,2842,958,1884,1900
gurly,FALSE,4841941,2659,990,1669,1824.5
grift,FALSE,4841927,2658,936,1722,1797
burke,FALSE,4841921,2819,1001,1818,1910
sedgy,FALSE,4841527,2761,1123,1638,1942
jerid,FALSE,4841200,2937,701,2236,1819
bokes,FALSE,4841062,2816,818,1998,1817
caulk,TRUE,4841007,2664,942,1722,1803
women,TRUE,4840740,2771,871,1900,1821
maiko,FALSE,4839666,2729,790,1939,1759.5
roguy,FALSE,4839663,2684,897,1787,1790.5
roost,TRUE,4839605,2795,1052,1743,1923.5
nkosi,FALSE,4839594,2690,473,2217,1581.5
czars,FALSE,4839554,2847,695,2152,1771
rakee,FALSE,4839519,3004,1163,1841,2083.5
snipy,FALSE,4839383,2578,1133,1445,1855.5
chief,TRUE,4839292,2737,952,1785,1844.5
molys,FALSE,4839149,2654,537,2117,1595.5
bugle,TRUE,4839121,2728,1012,1716,1870
elite,TRUE,4839013,3018,1102,1916,2060
marae,FALSE,4838769,3100,1161,1939,2130.5
blive,FALSE,4838627,2767,1110,1657,1938.5
zebra,TRUE,4838514,3104,518,2586,1811
perea,FALSE,4838268,3148,929,2219,2038.5
muons,FALSE,4838181,2596,755,1841,1675.5
peavy,FALSE,4837832,2877,1101,1776,1989
vined,FALSE,4837831,2772,820,1952,1796
murly,FALSE,4837669,2657,982,1675,1819.5
teaed,FALSE,4837596,3002,1134,1868,2068
femur,TRUE,4837469,2855,733,2122,1794
nikau,FALSE,4837137,2765,415,2350,1590
famed,FALSE,4837083,2840,937,1903,1888.5
raias,FALSE,4837032,3011,874,2137,1942.5
knurl,FALSE,4836957,2694,580,2114,1637
winge,FALSE,4836648,2747,924,1823,1835.5
oucht,FALSE,4836388,2624,564,2060,1594
ollie,FALSE,4835780.5,3024,936,2088,1980
stung,TRUE,4835755,2592,831,1761,1711.5
valid,TRUE,4835358,2723,735,1988,1729
teles,FALSE,4835288,2989,857,2132,1923
shewn,FALSE,4834698,2797,842,1955,1819.5
batch,TRUE,4834496,2670,879,1791,1774.5
odeum,FALSE,4834389,2854,362,2492,1608
upend,FALSE,4833956,2779,571,2208,1675
taira,FALSE,4833877,3060,935,2125,1997.5
lakhs,FALSE,4833846,2756,468,2288,1612
pilaw,FALSE,4833711,2744,636,2108,1690
senvy,FALSE,4833579,2790,1157,1633,1973.5
palki,FALSE,4833567,2752,624,2128,1688
carvy,FALSE,4833068,2760,1075,1685,1917.5
clamp,TRUE,4833067,2649,830,1819,1739.5
walds,FALSE,4833026,2739,604,2135,1671.5
drows,FALSE,4832814,2692,683,2009,1687.5
lotte,FALSE,4832676,3044,1041,2003,2042.5
oinks,FALSE,4832552,2690,473,2217,1581.5
polka,TRUE,4832527,2778,652,2126,1715
scrum,TRUE,4832336,2658,693,1965,1675.5
frond,TRUE,4832142,2637,947,1690,1792
ouzel,FALSE,4831710,2869,712,2157,1790.5
torta,FALSE,4831568,3086,794,2292,1940
indew,FALSE,4831515,2817,531,2286,1674
lense,FALSE,4831513,2872,1064,1808,1968
renin,FALSE,4831392.5,3090,774,2316,1932
venus,FALSE,4831217,2830,542,2288,1686
loral,FALSE,4831106,3067,849,2218,1958
links,FALSE,4831070,2665,520,2145,1592.5
noway,FALSE,4830975,2743,869,1874,1806
ulmin,FALSE,4830492,2600,583,2017,1591.5
smeik,FALSE,4830352,2821,852,1969,1836.5
cowed,FALSE,4830324,2741,939,1802,1840
ulvas,FALSE,4830145,2781,482,2299,1631.5
ledgy,FALSE,4830045,2791,845,1946,1818
boyau,FALSE,4830002,2723,645,2078,1684
uncap,FALSE,4829663,2710,395,2315,1552.5
blype,FALSE,4829405,2734,877,1857,1805.5
perky,TRUE,4829351,2858,966,1892,1912
lambs,FALSE,4829339,2740,513,2227,1626.5
knave,TRUE,4829309,2866,884,1982,1875
klaps,FALSE,4829169,2723,614,2109,1668.5
bowne,FALSE,4829110,2740,1084,1656,1912
bitsy,FALSE,4829037,2616,1021,1595,1818.5
bravi,FALSE,4828886,2809,804,2005,1806.5
devis,FALSE,4828681,2840,596,2244,1718
gourd,TRUE,4828645,2637,829,1808,1733
unlaw,FALSE,4828512,2758,412,2346,1585
bunde,FALSE,4828360,2700,991,1709,1845.5
title,TRUE,4828252,3018,1048,1970,2033
adred,FALSE,4828244,3172,760,2412,1966
dated,FALSE,4828106.5,3002,962,2040,1982
bowes,FALSE,4827798,2808,832,1976,1820
spork,FALSE,4827468,2676,936,1740,1806
adzes,FALSE,4826942,2988,526,2462,1757
flued,FALSE,4826935,2738,938,1800,1838
amowt,FALSE,4826687,2741,701,2040,1721
avoid,TRUE,4826672,2748,676,2072,1712
swerf,FALSE,4826407,2912,765,2147,1838.5
musca,FALSE,4826343,2730,589,2141,1659.5
macho,TRUE,4826153,2707,553,2154,1630
nomic,FALSE,4826047,2616,566,2050,1591
shogi,FALSE,4826020,2617,841,1776,1729
trass,FALSE,4825943.5,3031,930,2101,1980.5
skelm,FALSE,4825577,2822,757,2065,1789.5
kenaf,FALSE,4825551,2924,590,2334,1757
tsubo,FALSE,4825446,2682,412,2270,1547
tiara,TRUE,4825424,3060,874,2186,1967
blaud,FALSE,4825251,2651,881,1770,1766
chems,FALSE,4824991,2799,623,2176,1711
kwela,FALSE,4824709,3009,467,2542,1738
goban,FALSE,4824555,2699,744,1955,1721.5
brigs,FALSE,4824118,2669,818,1851,1743.5
reels,FALSE,4823675.5,3159,722,2437,1940.5
nucha,FALSE,4823317,2743,371,2372,1557
armer,FALSE,4823267,3100,999,2101,2049.5
bogan,FALSE,4823183,2699,812,1887,1755.5
verbs,FALSE,4823078,2927,508,2419,1717.5
mohur,FALSE,4823011,2644,689,1955,1666.5
kogal,FALSE,4822189,2732,685,2047,1708.5
bulge,TRUE,4821834,2728,971,1757,1849.5
horks,FALSE,4821683,2709,602,2107,1655.5
leers,FALSE,4821483.5,3159,695,2464,1927
profs,FALSE,4821334,2681,724,1957,1702.5
spree,TRUE,4821078,2857,1332,1525,2094.5
quena,FALSE,4820891,3001,632,2369,1816.5
below,TRUE,4820779,2838,676,2162,1757
risky,TRUE,4820487,2721,806,1915,1763.5
gyeld,FALSE,4819724,2791,595,2196,1693
surgy,FALSE,4819720,2629,1155,1474,1892
speug,FALSE,4819699,2777,727,2050,1752
niner,FALSE,4819665,3090,908,2182,1999
mechs,FALSE,4819633,2799,469,2330,1634
cerne,FALSE,4819545,2891,1209,1682,2050
coxes,FALSE,4819380,2832,843,1989,1837.5
brims,FALSE,4819300,2667,810,1857,1738.5
cruft,FALSE,4818812,2616,918,1698,1767
khors,FALSE,4818696,2709,596,2113,1652.5
sibyl,FALSE,4818526,2597,784,1813,1690.5
linum,FALSE,4818135,2600,553,2047,1576.5
fords,FALSE,4818069,2705,683,2022,1694
plank,TRUE,4817782,2655,945,1710,1800
retro,TRUE,4817606,3233,668,2565,1950.5
quern,FALSE,4817587,2929,668,2261,1798.5
zedas,FALSE,4817513,2988,519,2469,1753.5
ratas,FALSE,4817422,3031,719,2312,1875
malik,FALSE,4817066,2704,794,1910,1749
bimas,FALSE,4817037,2739,635,2104,1687
rojis,FALSE,4816942,2802,581,2221,1691.5
pawls,FALSE,4816704,2715,670,2045,1692.5
waged,FALSE,4816346,2829,890,1939,1859.5
humor,TRUE,4816233,2644,660,1984,1652
puhas,FALSE,4816178,2709,536,2173,1622.5
tarts,FALSE,4816114,3031,791,2240,1911
inner,TRUE,4816042,3090,790,2300,1940
kerfs,FALSE,4815980,2920,496,2424,1708
dikas,FALSE,4815941,2746,524,2222,1635
thigs,FALSE,4815746,2611,671,1940,1641
aleye,FALSE,4815745.5,3030,946,2084,1988
goafs,FALSE,4815709,2707,772,1935,1739.5
goths,FALSE,4814969,2637,569,2068,1603
dorks,FALSE,4814948,2700,644,2056,1672
cozes,FALSE,4814858,2830,842,1988,1836
rough,TRUE,4814852,2646,764,1882,1705
yirks,FALSE,4814575,2721,462,2259,1591.5
fiche,FALSE,4814510,2737,846,1891,1791.5
onium,FALSE,4814225,2625,518,2107,1571.5
twirp,FALSE,4813734,2691,667,2024,1679
sybil,FALSE,4813718,2597,760,1837,1678.5
stock,TRUE,4813657,2608,952,1656,1780
sluse,FALSE,4813507.5,2779,1327,1452,2053
paved,FALSE,4813424,2830,931,1899,1880.5
busti,FALSE,4813176,2656,589,2067,1622.5
asset,TRUE,4812989,3250,808,2442,2029
mawed,FALSE,4812893,2827,873,1954,1850
shawn,FALSE,4812479,2650,972,1678,1811
doucs,FALSE,4811783,2566,743,1823,1654.5
wamed,FALSE,4811758,2827,884,1943,1855.5
hurds,FALSE,4811711,2661,523,2138,1592
borms,FALSE,4811422,2693,719,1974,1706
corby,FALSE,4811262,2642,1028,1614,1835
arris,FALSE,4810863,3011,765,2246,1888
yogin,FALSE,4810843,2587,640,1947,1613.5
moths,FALSE,4810697,2635,561,2074,1598
osmic,FALSE,4810680,2684,307,2377,1495.5
broch,FALSE,4810608,2604,975,1629,1789.5
fends,FALSE,4810500,2801,622,2179,1711.5
brize,FALSE,4810468,2842,1150,1692,1996
simba,FALSE,4810369,2739,717,2022,1728
tying,TRUE,4810313,2581,661,1920,1621
foams,FALSE,4810276,2705,826,1879,1765.5
glady,FALSE,4809883,2644,1056,1588,1850
cecal,FALSE,4809881,3061,815,2246,1938
slick,TRUE,4809874,2563,1098,1465,1830.5
stomp,TRUE,4809586,2602,811,1791,1706.5
douma,FALSE,4809517,2707,687,2020,1697
steel,TRUE,4809213.5,2989,1094,1895,2041.5
mixer,FALSE,4808949,2875,851,2024,1863
azlon,FALSE,4808284,2815,517,2298,1666
lurgy,FALSE,4808238,2659,877,1782,1768
smaik,FALSE,4808133,2674,982,1692,1828
honds,FALSE,4808122,2590,592,1998,1591
daled,FALSE,4807422.5,2983,963,2020,1973
folic,FALSE,4807053,2623,716,1907,1669.5
thong,TRUE,4806569,2569,760,1809,1664.5
pouty,TRUE,4805886,2560,1089,1471,1824.5
okapi,FALSE,4804858,2777,419,2358,1598
ester,TRUE,4804685,3178,729,2449,1953.5
zoist,FALSE,4804571,2640,972,1668,1806
devon,FALSE,4804353,2798,664,2134,1731
swarf,FALSE,4804188,2765,895,1870,1830
velds,FALSE,4804149,2841,502,2339,1671.5
month,TRUE,4804086,2567,803,1764,1685
hoing,FALSE,4803513,2549,837,1712,1693
covey,TRUE,4803488,2743,1208,1535,1975.5
corer,TRUE,4803126,3014,1170,1844,2092
darky,FALSE,4802990,2735,997,1738,1866
raita,FALSE,4802827,3060,878,2182,1969
chams,FALSE,4802772,2652,753,1899,1702.5
mangs,FALSE,4802578,2675,662,2013,1668.5
pubes,FALSE,4802426,2744,739,2005,1741.5
ambos,FALSE,4802250,2765,404,2361,1584.5
group,TRUE,4802163,2613,764,1849,1688.5
exons,FALSE,4802126,2934,548,2386,1741
maxes,FALSE,4801949,2918,777,2141,1847.5
doxie,FALSE,4801907,2783,984,1799,1883.5
minty,TRUE,4801834,2579,951,1628,1765
gazes,FALSE,4801699,2918,784,2134,1851
adder,FALSE,4801453.5,3172,766,2406,1969
almud,FALSE,4801170,2682,603,2079,1642.5
vaped,FALSE,4800818,2830,841,1989,1835.5
tryer,FALSE,4800518,2977,975,2002,1976
campo,FALSE,4800223,2674,671,2003,1672.5
fount,FALSE,4799974,2554,1015,1539,1784.5
feign,TRUE,4799920,2760,850,1910,1805
iambs,FALSE,4799881,2739,459,2280,1599
barmy,FALSE,4799464,2728,1072,1656,1900
cerci,FALSE,4799057,2988,766,2222,1877
feare,FALSE,4799041,3009,1261,1748,2135
limba,FALSE,4798887,2769,439,2330,1604
xrays,FALSE,4798836,2818,613,2205,1715.5
creel,FALSE,4798781.5,2989,1116,1873,2052.5
pyins,FALSE,4798736,2578,649,1929,1613.5
rumly,FALSE,4798687,2657,878,1779,1767.5
infos,FALSE,4798151,2695,314,2381,1504.5
beaky,FALSE,4798107,2851,1141,1710,1996
moves,FALSE,4798015,2794,789,2005,1791.5
iglus,FALSE,4797796,2670,276,2394,1473
obang,FALSE,4797523,2699,587,2112,1643
bowat,FALSE,4797522,2710,894,1816,1802
growl,TRUE,4797460,2652,807,1845,1729.5
mazes,FALSE,4797427,2916,776,2140,1846
kitul,FALSE,4797308,2621,571,2050,1596
modge,FALSE,4797266,2697,961,1736,1829
virga,FALSE,4796984,2842,548,2294,1695
doing,TRUE,4796778,2540,879,1661,1709.5
holms,FALSE,4796778,2616,564,2052,1590
boxer,TRUE,4796430,2870,994,1876,1932
tract,TRUE,4796332,2861,1128,1733,1994.5
handy,TRUE,4796164,2625,945,1680,1785
gavot,FALSE,4795819,2698,853,1845,1775.5
bikes,FALSE,4795156,2790,741,2049,1765.5
gauds,FALSE,4795152,2654,689,1965,1671.5
tungs,FALSE,4795011,2592,586,2006,1589
phons,FALSE,4794992,2566,748,1818,1657
madly,TRUE,4794958,2642,1012,1630,1827
prows,FALSE,4794657,2668,714,1954,1691
tuxes,FALSE,4794382,2835,701,2134,1768
riata,FALSE,4794374,3060,817,2243,1938.5
meshy,FALSE,4794111,2768,821,1947,1794.5
snars,FALSE,4793759,2914,948,1966,1931
coifs,FALSE,4793524,2593,814,1779,1703.5
nevus,FALSE,4793411,2830,446,2384,1638
touks,FALSE,4793285,2617,684,1933,1650.5
lucid,TRUE,4793220,2570,606,1964,1588
chuts,FALSE,4793092,2569,682,1887,1625.5
virus,TRUE,4792880,2708,526,2182,1617
drink,TRUE,4792826,2606,939,1667,1772.5
words,FALSE,4792744,2692,630,2062,1661
mewls,FALSE,4792483,2814,573,2241,1693.5
flegs,FALSE,4792384,2829,626,2203,1727.5
awork,FALSE,4792247,2815,694,2121,1754.5
kibes,FALSE,4792224,2790,633,2157,1711.5
gramp,FALSE,4792139,2690,813,1877,1751.5
munts,FALSE,4791200,2590,607,1983,1598.5
golds,FALSE,4791132,2609,611,1998,1610
mauds,FALSE,4790880,2652,681,1971,1666.5
trior,FALSE,4790632,2824,1026,1798,1925
dempt,FALSE,4790446,2737,717,2020,1727
vison,FALSE,4789992,2637,587,2050,1612
artal,FALSE,4789801,3061,838,2223,1949.5
impot,FALSE,4789398,2631,515,2116,1573
sures,FALSE,4789302,2968,1069,1899,2018.5
umble,FALSE,4789250,2726,714,2012,1720
sensi,FALSE,4789249.5,2871,929,1942,1900
mudir,FALSE,4788834,2609,738,1871,1673.5
drown,TRUE,4788466,2624,777,1847,1700.5
yanks,FALSE,4788394,2696,540,2156,1618
axons,FALSE,4788116,2787,617,2170,1702
nurdy,FALSE,4787368,2631,819,1812,1725
cohab,FALSE,4787266,2676,660,2016,1668
gamut,TRUE,4787086,2631,815,1816,1723
chirm,FALSE,4787066,2609,802,1807,1705.5
fouls,FALSE,4786936,2603,778,1825,1690.5
tapet,FALSE,4786920,2978,1082,1896,2030
molds,FALSE,4786860,2607,603,2004,1605
joist,TRUE,4786591,2632,989,1643,1810.5
expat,FALSE,4786548,3015,560,2455,1787.5
ivory,TRUE,4786488,2723,809,1914,1766
raper,FALSE,4786306,3148,997,2151,2072.5
mirex,FALSE,4786243,2875,798,2077,1836.5
saran,FALSE,4786122,2914,1126,1788,2020
bring,TRUE,4785741,2601,929,1672,1765
sones,FALSE,4785713,2897,1138,1759,2017.5
mohua,FALSE,4785559,2716,541,2175,1628.5
wends,FALSE,4785175,2788,569,2219,1678.5
tozed,FALSE,4785028,2801,875,1926,1838
heath,TRUE,4784934,3011,896,2115,1953.5
stick,TRUE,4784457,2582,974,1608,1778
slats,FALSE,4784193,2842,1049,1793,1945.5
pronk,FALSE,4783869,2608,948,1660,1778
azons,FALSE,4783374,2785,605,2180,1695
debus,FALSE,4783231,2768,528,2240,1648
altar,TRUE,4783206,3061,828,2233,1944.5
ansae,FALSE,4782914,3133,895,2238,2014
yugas,FALSE,4782905,2701,458,2243,1579.5
bouns,FALSE,4782780,2565,835,1730,1700
thrum,TRUE,4782604,2638,580,2058,1609
unpay,FALSE,4782517,2679,705,1974,1692
fetch,TRUE,4781948,2757,780,1977,1768.5
tofus,FALSE,4781850,2622,571,2051,1596.5
favor,TRUE,4781684,2775,833,1942,1804
quine,FALSE,4781684,2739,1081,1658,1910
truck,TRUE,4781251,2611,846,1765,1728.5
scoup,FALSE,4780826,2542,788,1754,1665
whens,FALSE,4780782,2797,622,2175,1709.5
embay,FALSE,4780494,2947,694,2253,1820.5
softy,FALSE,4780242,2582,1173,1409,1877.5
quest,TRUE,4780172,2827,810,2017,1818.5
sails,FALSE,4780118,2822,1134,1688,1978
unsaw,FALSE,4780050,2728,380,2348,1554
roses,FALSE,4779917,3184,818,2366,2001
whirs,FALSE,4779717,2675,681,1994,1678
hydro,TRUE,4779379,2676,377,2299,1526.5
etats,FALSE,4779332,3250,631,2619,1940.5
batik,FALSE,4779325,2692,859,1833,1775.5
burly,TRUE,4779244,2626,1048,1578,1837
yawns,FALSE,4779172,2688,554,2134,1621
rared,FALSE,4778865,3172,1008,2164,2090
fecht,FALSE,4778402,2757,715,2042,1736
hocus,FALSE,4778048,2575,522,2053,1548.5
pikas,FALSE,4777784,2722,555,2167,1638.5
thing,TRUE,4777369,2543,782,1761,1662.5
trump,TRUE,4777180,2605,705,1900,1655
spank,TRUE,4777114,2625,1029,1596,1827
flocs,FALSE,4776923,2594,769,1825,1681.5
porks,FALSE,4776791,2676,675,2001,1675.5
yamun,FALSE,4776635,2631,583,2048,1607
ludic,FALSE,4776584,2570,538,2032,1554
herse,FALSE,4776220,2890,1069,1821,1979.5
scowl,TRUE,4776123,2581,831,1750,1706
ankus,FALSE,4776033,2736,358,2378,1547
grody,FALSE,4775970,2597,1059,1538,1828
scuba,TRUE,4775782,2699,659,2040,1679
panko,FALSE,4775742,2680,698,1982,1689
odism,FALSE,4775171,2606,540,2066,1573
bosun,FALSE,4775062,2565,744,1821,1654.5
munis,FALSE,4775050,2570,626,1944,1598
dried,TRUE,4775018.5,2910,1080,1830,1995
tupek,FALSE,4774959,2728,824,1904,1776
roral,FALSE,4774929,3067,866,2201,1966.5
awdls,FALSE,4774837,2739,458,2281,1598.5
picul,FALSE,4774520,2546,638,1908,1592
hokey,FALSE,4774178,2727,1042,1685,1884.5
eared,FALSE,4774097,3172,975,2197,2073.5
murid,FALSE,4773807,2609,732,1877,1670.5
wacke,FALSE,4773412,2809,922,1887,1865.5
james,FALSE,4773299,2908,739,2169,1823.5
bogey,FALSE,4773127,2713,1201,1512,1957
ratan,FALSE,4773074,2963,813,2150,1888
frank,TRUE,4772765,2705,1005,1700,1855
scudo,FALSE,4772155,2566,698,1868,1632
phyla,FALSE,4771626,2699,541,2158,1620
machi,FALSE,4771609,2681,506,2175,1593.5
splog,FALSE,4771482,2585,712,1873,1648.5
glops,FALSE,4771352,2585,646,1939,1615.5
cymas,FALSE,4771317,2690,481,2209,1585.5
docus,FALSE,4771313,2566,564,2002,1565
scamp,TRUE,4770802,2619,837,1782,1728
mocha,TRUE,4770569,2707,534,2173,1620.5
cozen,FALSE,4770510,2762,936,1826,1849
vinos,FALSE,4770433,2637,552,2085,1594.5
mobey,FALSE,4770227,2711,1125,1586,1918
flags,FALSE,4770165,2682,756,1926,1719
scrub,TRUE,4770150,2627,662,1965,1644.5
crimp,TRUE,4769954,2576,855,1721,1715.5
sials,FALSE,4769556,2822,1073,1749,1947.5
seame,FALSE,4769507,2881,1407,1474,2144
docht,FALSE,4769289,2537,727,1810,1632
penks,FALSE,4769222,2772,614,2158,1693
chang,FALSE,4769213,2586,872,1714,1729
dirks,FALSE,4769042,2674,567,2107,1620.5
aglee,FALSE,4769039,2913,1007,1906,1960
lofty,TRUE,4768760,2612,895,1717,1753.5
maiks,FALSE,4768628,2674,768,1906,1721
khans,FALSE,4768342,2658,689,1969,1673.5
minus,TRUE,4768022,2570,566,2004,1568
munge,FALSE,4767890,2661,932,1729,1796.5
maund,FALSE,4767875,2584,876,1708,1730
baked,FALSE,4767732,2804,925,1879,1864.5
schul,FALSE,4767612,2550,653,1897,1601.5
vints,FALSE,4766563,2631,559,2072,1595
ketch,FALSE,4766402,2752,664,2088,1708
tuart,FALSE,4766366,2870,1047,1823,1958.5
hudna,FALSE,4766281,2665,576,2089,1620.5
powan,FALSE,4766078,2672,740,1932,1706
subah,FALSE,4766032,2630,911,1719,1770.5
bench,TRUE,4765961,2700,845,1855,1772.5
bourd,FALSE,4765948,2604,887,1717,1745.5
flams,FALSE,4765347,2680,748,1932,1714
parky,FALSE,4764833,2711,1028,1683,1869.5
lungi,FALSE,4764603,2602,500,2102,1551
gursh,FALSE,4764522,2591,774,1817,1682.5
ganch,FALSE,4764140,2586,849,1737,1717.5
coups,FALSE,4763966,2542,728,1814,1635
sulfo,FALSE,4763850,2603,757,1846,1680
adown,FALSE,4763783,2696,560,2136,1628
sisal,FALSE,4763782,2822,967,1855,1894.5
misdo,FALSE,4763530,2606,516,2090,1561
lying,TRUE,4763411,2562,600,1962,1581
ponds,FALSE,4763230,2557,665,1892,1611
chaft,FALSE,4762702,2610,937,1673,1773.5
hinds,FALSE,4762216,2564,515,2049,1539.5
bliny,FALSE,4762167,2529,1186,1343,1857.5
ephod,FALSE,4761949,2824,392,2432,1608
fonda,FALSE,4761436,2709,687,2022,1698
petre,FALSE,4761335,2906,1071,1835,1988.5
felch,FALSE,4761264,2738,781,1957,1759.5
incog,FALSE,4761034,2618,350,2268,1484
hymen,TRUE,4760723,2700,601,2099,1650.5
shoyu,FALSE,4760574,2544,758,1786,1651
soupy,FALSE,4760088,2511,1224,1287,1867.5
boree,FALSE,4759511,2833,1357,1476,2095
kaims,FALSE,4759386,2674,694,1980,1684
dicty,FALSE,4759219,2549,872,1677,1710.5
chive,FALSE,4758986,2679,1078,1601,1878.5
makos,FALSE,4758759,2700,591,2109,1645.5
lingy,FALSE,4758743,2562,869,1693,1715.5
kagos,FALSE,4758727,2702,559,2143,1630.5
radix,FALSE,4758671,2800,650,2150,1725
mease,FALSE,4758509,2881,1251,1630,2066
diwan,FALSE,4758329,2670,632,2038,1651
tichy,FALSE,4758182,2558,799,1759,1678.5
salat,FALSE,4758030,2842,1198,1644,2020
satis,FALSE,4758018,2841,975,1866,1908
navew,FALSE,4758010,2858,725,2133,1791.5
nazis,FALSE,4757925,2759,546,2213,1652.5
trist,FALSE,4757781,2769,1106,1663,1937.5
mutha,FALSE,4757653,2710,496,2214,1603
enter,TRUE,4757338,3110,800,2310,1955
wisha,FALSE,4757265,2747,457,2290,1602
yukes,FALSE,4756436,2750,558,2192,1654
gives,FALSE,4756381,2770,720,2050,1745
ngoma,FALSE,4756269,2730,425,2305,1577.5
jutes,FALSE,4756246,2825,671,2154,1748
kheda,FALSE,4755690,2916,474,2442,1695
bonus,TRUE,4755503,2565,709,1856,1637
machs,FALSE,4755115,2652,531,2121,1591.5
laded,FALSE,4755036.5,2983,903,2080,1943
using,TRUE,4754863,2572,538,2034,1555
curbs,FALSE,4754722,2627,607,2020,1617
nikah,FALSE,4754679,2687,553,2134,1620
prink,FALSE,4754669,2582,970,1612,1776
scody,FALSE,4754633,2526,1083,1443,1804.5
tocks,FALSE,4754367,2608,575,2033,1591.5
umbel,FALSE,4753986,2726,602,2124,1664
salts,FALSE,4753484,2842,957,1885,1899.5
sorra,FALSE,4753414,3037,1024,2013,2030.5
wecht,FALSE,4753077,2744,662,2082,1703
roots,FALSE,4752770,2795,803,1992,1799
ratoo,FALSE,4752457,3086,710,2376,1898
wilco,FALSE,4752165,2610,607,2003,1608.5
there,TRUE,4751820.5,2939,1046,1893,1992.5
totes,FALSE,4751624,3014,893,2121,1953.5
yoked,FALSE,4751604,2718,733,1985,1725.5
ceres,FALSE,4751506,2959,957,2002,1958
unpeg,FALSE,4751414,2709,537,2172,1623
midge,TRUE,4751360,2671,884,1787,1777.5
pandy,FALSE,4751272,2592,1018,1574,1805
clows,FALSE,4751118,2581,704,1877,1642.5
fused,FALSE,4750884,2708,838,1870,1773
gaups,FALSE,4750807,2630,670,1960,1650
fusil,FALSE,4750736,2577,716,1861,1646.5
garre,FALSE,4750531,3102,1158,1944,2130
shrug,TRUE,4750485,2591,796,1795,1693.5
glaum,FALSE,4750380,2612,747,1865,1679.5
drier,TRUE,4750343,2910,1174,1736,2042
cauks,FALSE,4749785,2634,758,1876,1696
knurs,FALSE,4749687,2664,460,2204,1562
albee,FALSE,4749684,2880,1141,1739,2010.5
hanks,FALSE,4749596,2658,603,2055,1630.5
downa,FALSE,4749093,2696,662,2034,1679
ensky,FALSE,4748838,2843,658,2185,1750.5
shiva,FALSE,4748710,2702,886,1816,1794
ducts,FALSE,4748585,2560,528,2032,1544
owche,FALSE,4748464,2750,593,2157,1671.5
lungs,FALSE,4748109,2573,525,2048,1549
flics,FALSE,4747723,2568,791,1777,1679.5
luxes,FALSE,4747480,2816,640,2176,1728
sculp,FALSE,4747462,2517,789,1728,1653
plims,FALSE,4747251,2557,713,1844,1635
blady,FALSE,4747186,2611,1114,1497,1862.5
imbue,TRUE,4747098,2725,635,2090,1680
golps,FALSE,4746787,2585,592,1993,1588.5
mulct,FALSE,4746629,2518,810,1708,1664
sades,FALSE,4746591,2953,1099,1854,2026
unbed,FALSE,4746489,2700,613,2087,1656.5
viand,FALSE,4746358,2625,852,1773,1738.5
fands,FALSE,4745982,2654,684,1970,1669
fitly,FALSE,4745736,2586,975,1611,1780.5
campi,FALSE,4745679,2648,624,2024,1636
boaks,FALSE,4745547,2669,850,1819,1759.5
cowls,FALSE,4745396,2581,701,1880,1641
gilds,FALSE,4745226,2583,534,2049,1558.5
exult,TRUE,4745152,2865,666,2199,1765.5
ceroc,FALSE,4744324.5,3014,766,2248,1890
bangs,FALSE,4744153,2644,728,1916,1686
endow,TRUE,4744119,2843,383,2460,1613
sicko,FALSE,4744079,2588,737,1851,1662.5
biped,FALSE,4743716,2686,869,1817,1777.5
duvet,TRUE,4743691,2699,917,1782,1808
spawn,TRUE,4743554,2617,889,1728,1753
towsy,FALSE,4743173,2569,989,1580,1779
taint,TRUE,4743022,2773,1154,1619,1963.5
plong,FALSE,4742892,2517,810,1707,1663.5
danks,FALSE,4742861,2649,645,2004,1647
surer,TRUE,4742708,2968,1245,1723,2106.5
loxed,FALSE,4742648,2784,815,1969,1799.5
tacky,TRUE,4742409,2643,928,1715,1785.5
child,TRUE,4742376,2492,888,1604,1690
quail,TRUE,4742238,2690,830,1860,1760
coved,FALSE,4742116,2696,962,1734,1829
coxal,FALSE,4742114,2715,808,1907,1761.5
brush,TRUE,4741927,2558,915,1643,1736.5
sylva,FALSE,4741360,2741,611,2130,1676
milds,FALSE,4740954,2581,526,2055,1553.5
losel,FALSE,4740480,2995,921,2074,1958
rewax,FALSE,4740450,3033,544,2489,1788.5
clonk,FALSE,4740330,2521,938,1583,1729.5
palmy,FALSE,4739928,2618,990,1628,1804
jodel,FALSE,4739839,2774,848,1926,1811
sines,FALSE,4739807,2871,1061,1810,1966
humas,FALSE,4739519,2661,515,2146,1588
bydes,FALSE,4739267,2728,625,2103,1676.5
eagre,FALSE,4739091,3102,1019,2083,2060.5
bodge,FALSE,4738841,2666,1027,1639,1846.5
fyces,FALSE,4738794,2746,569,2177,1657.5
makis,FALSE,4738739,2674,617,2057,1645.5
yowed,FALSE,4738340,2710,747,1963,1728.5
dormy,FALSE,4737803,2595,985,1610,1790
vinca,FALSE,4737799,2703,600,2103,1651.5
arvee,FALSE,4737745,2951,1199,1752,2075
roars,FALSE,4737004,3037,879,2158,1958
ympes,FALSE,4736742,2735,456,2279,1595.5
badly,TRUE,4736533,2611,1078,1533,1844.5
tenno,FALSE,4736388.5,2946,770,2176,1858
frogs,FALSE,4736252,2635,759,1876,1697
troll,TRUE,4736061,2825,978,1847,1901.5
geums,FALSE,4735957,2729,626,2103,1677.5
welch,TRUE,4735939,2725,728,1997,1726.5
shift,TRUE,4735438,2518,1064,1454,1791
knout,FALSE,4735053,2549,686,1863,1617.5
lisle,FALSE,4734839,2969,956,2013,1962.5
copsy,FALSE,4734827,2502,1070,1432,1786
potch,FALSE,4734678,2513,823,1690,1668
snies,FALSE,4734415,2871,1073,1798,1972
warks,FALSE,4734218,2760,641,2119,1700.5
kamis,FALSE,4734119,2674,579,2095,1626.5
study,TRUE,4734087,2529,1041,1488,1785
oxide,TRUE,4734019,2783,814,1969,1798.5
rises,FALSE,4734011,3158,741,2417,1949.5
dawns,FALSE,4733639,2641,659,1982,1650
solas,FALSE,4733546,2848,956,1892,1902
brack,FALSE,4733513,2663,1012,1651,1837.5
ameer,FALSE,4733495.5,3100,886,2214,1993
izard,FALSE,4733364,2798,613,2185,1705.5
eughs,FALSE,4733245,2810,389,2421,1599.5
nobly,TRUE,4733215,2555,899,1656,1727
ganof,FALSE,4733168,2639,716,1923,1677.5
kythe,FALSE,4732970,2721,606,2115,1663.5
dumas,FALSE,4732784,2652,557,2095,1604.5
bunts,FALSE,4732775,2559,673,1886,1616
bigot,TRUE,4732711,2554,827,1727,1690.5
stoas,FALSE,4732694,2867,886,1981,1876.5
bauds,FALSE,4732455,2621,747,1874,1684
ampul,FALSE,4732090,2658,475,2183,1566.5
ohing,FALSE,4731949,2549,674,1875,1611.5
rownd,FALSE,4731892,2624,710,1914,1667
stell,FALSE,4731356,2989,938,2051,1963.5
perse,FALSE,4731328,2857,1142,1715,1999.5
lurer,FALSE,4731226,2998,967,2031,1982.5
gonys,FALSE,4731052,2558,572,1986,1565
joual,FALSE,4730814,2714,783,1931,1748.5
joled,FALSE,4730730,2774,847,1927,1810.5
fauve,FALSE,4730216,2778,1075,1703,1926.5
azurn,FALSE,4730050,2788,590,2198,1689
daubs,FALSE,4730005,2621,640,1981,1630.5
blond,TRUE,4729995,2508,918,1590,1713
mashy,FALSE,4729593,2621,883,1738,1752
groks,FALSE,4729402,2630,717,1913,1673.5
pokey,FALSE,4729286,2694,1115,1579,1904.5
fumet,FALSE,4729193,2685,954,1731,1819.5
camps,FALSE,4729185,2619,649,1970,1634
calix,FALSE,4729114,2689,780,1909,1734.5
bolds,FALSE,4728435,2576,669,1907,1622.5
aphid,TRUE,4727919,2651,487,2164,1569
deter,TRUE,4727861,2930,994,1936,1962
birch,TRUE,4727624,2578,829,1749,1703.5
flume,TRUE,4727539,2666,994,1672,1830
barer,FALSE,4727270,3069,1170,1899,2119.5
ditch,TRUE,4726929,2511,715,1796,1613
timps,FALSE,4726779,2576,498,2078,1537
night,TRUE,4726458,2543,587,1956,1565
thowl,FALSE,4726391,2561,718,1843,1639.5
welkt,FALSE,4726296,2767,745,2022,1756
envoy,TRUE,4726253,2845,704,2141,1774.5
drugs,FALSE,4726183,2582,655,1927,1618.5
pavis,FALSE,4726006,2669,689,1980,1679
kaing,FALSE,4725827,2608,813,1795,1710.5
aglow,TRUE,4725507,2724,414,2310,1569
habus,FALSE,4725448,2630,548,2082,1589
thack,FALSE,4725141,2605,865,1740,1735
swami,TRUE,4724818,2666,796,1870,1731
polje,FALSE,4724780,2750,959,1791,1854.5
ceric,FALSE,4724304.5,2988,792,2196,1890
cadee,FALSE,4724158,2783,1319,1464,2051
oflag,FALSE,4723945,2737,365,2372,1551
topee,FALSE,4723861,2742,1228,1514,1985
crudy,FALSE,4723655,2529,1063,1466,1796
darzi,FALSE,4723613,2798,609,2189,1703.5
jiber,FALSE,4723562,2834,809,2025,1821.5
dicht,FALSE,4723383,2511,650,1861,1580.5
kilty,FALSE,4723166,2581,837,1744,1709
dusty,TRUE,4723063,2529,880,1649,1704.5
tenes,FALSE,4722919,2891,884,2007,1887.5
gyrus,FALSE,4722805,2629,419,2210,1524
froze,TRUE,4722602,2808,1091,1717,1949.5
imped,FALSE,4722536,2717,566,2151,1641.5
yeuks,FALSE,4722319,2750,504,2246,1627
arias,FALSE,4722141,3011,873,2138,1942
stoat,FALSE,4722072,2867,1103,1764,1985
fugle,FALSE,4722055,2668,975,1693,1821.5
tushy,FALSE,4722026,2538,807,1731,1672.5
pervy,FALSE,4721912,2805,957,1848,1881
easts,FALSE,4721725,3250,631,2619,1940.5
mowas,FALSE,4721687,2692,611,2081,1651.5
dikey,FALSE,4721537,2692,1007,1685,1849.5
gouty,FALSE,4721419,2514,1062,1452,1788
drums,FALSE,4721365,2580,647,1933,1613.5
coact,FALSE,4721243,2697,1189,1508,1943
agger,FALSE,4721025.5,3102,750,2352,1926
mamie,FALSE,4720759,2910,1054,1856,1982
wands,FALSE,4720657,2641,631,2010,1636
thilk,FALSE,4720355,2543,834,1709,1688.5
babel,FALSE,4720290,2880,1008,1872,1944
elbow,TRUE,4720162,2838,479,2359,1658.5
vegos,FALSE,4720071,2796,520,2276,1658
uncoy,FALSE,4719733,2545,672,1873,1608.5
ficos,FALSE,4719642,2593,562,2031,1577.5
fugie,FALSE,4719565,2667,971,1696,1819
aided,FALSE,4718994.5,2982,854,2128,1918
pagod,FALSE,4718191,2598,763,1835,1680.5
flosh,FALSE,4718104,2525,891,1634,1708
sebum,FALSE,4717930,2696,789,1907,1742.5
grypt,FALSE,4717801,2567,714,1853,1640.5
allot,TRUE,4717650.5,2897,839,2058,1868
scudi,FALSE,4717611,2540,651,1889,1595.5
kutis,FALSE,4717066,2591,511,2080,1551
kluge,FALSE,4716811,2663,886,1777,1774.5
baldy,FALSE,4716477,2611,1022,1589,1816.5
shere,FALSE,4716400.5,2890,1263,1627,2076.5
klang,FALSE,4716242,2609,751,1858,1680
haick,FALSE,4715941,2585,904,1681,1744.5
kiang,FALSE,4715265,2608,752,1856,1680
dalle,FALSE,4715096,2983,1113,1870,2048
sagum,FALSE,4714737,2582,861,1721,1721.5
divas,FALSE,4714469,2693,561,2132,1627
rasta,FALSE,4714071,3031,692,2339,1861.5
tenon,FALSE,4713864.5,2946,792,2154,1869
rumba,TRUE,4713763,2768,440,2328,1604
pling,FALSE,4713692,2491,832,1659,1661.5
esile,FALSE,4713668,2969,940,2029,1954.5
fauld,FALSE,4713606,2591,885,1706,1738
sorts,FALSE,4713202,2795,983,1812,1889
hoked,FALSE,4712806,2680,796,1884,1738
sooey,FALSE,4712442,2764,1571,1193,2167.5
spicy,TRUE,4712345,2476,1209,1267,1842.5
flype,FALSE,4712339,2674,840,1834,1757
chalk,TRUE,4712199,2586,924,1662,1755
prier,FALSE,4712186,2886,1205,1681,2045.5
alley,TRUE,4712160.5,3030,1136,1894,2083
fakey,FALSE,4712038,2791,1134,1657,1962.5
given,TRUE,4712033,2702,814,1888,1758
sista,FALSE,4711904,2841,851,1990,1846
ottar,FALSE,4711882,3086,604,2482,1845
bahus,FALSE,4711680,2630,604,2026,1617
amoks,FALSE,4711639,2700,514,2186,1607
sowth,FALSE,4711524,2531,949,1582,1740
crees,FALSE,4711511.5,2959,996,1963,1977.5
clink,TRUE,4711130,2495,960,1535,1727.5
dukes,FALSE,4710903,2703,663,2040,1683
smirk,TRUE,4710555,2602,935,1667,1768.5
grows,FALSE,4710190,2622,687,1935,1654.5
twang,TRUE,4710185,2620,723,1897,1671.5
fagin,FALSE,4709905,2613,795,1818,1704
carat,TRUE,4709668,2861,1081,1780,1971
waift,FALSE,4709537,2624,941,1683,1782.5
magic,TRUE,4709389,2602,667,1935,1634.5
stall,TRUE,4709137,2842,1068,1774,1955
gamic,FALSE,4709073,2602,669,1933,1635.5
decko,FALSE,4708906,2749,522,2227,1635.5
deify,FALSE,4708567,2697,1018,1679,1857.5
ticks,FALSE,4708461,2582,498,2084,1540
guyot,FALSE,4708441,2514,715,1799,1614.5
rager,FALSE,4708439,3102,1006,2096,2054
squat,TRUE,4708288,2680,952,1728,1816
futon,FALSE,4708284,2554,695,1859,1624.5
bafts,FALSE,4708264,2668,677,1991,1672.5
ambry,FALSE,4708038,2728,752,1976,1740
craal,FALSE,4708009,2842,1091,1751,1966.5
dingo,TRUE,4707624,2540,586,1954,1563
primy,FALSE,4707524,2545,1107,1438,1826
sirra,FALSE,4707508,3011,947,2064,1979
locks,FALSE,4707465,2589,514,2075,1551.5
frigs,FALSE,4707052,2609,781,1828,1695
trill,FALSE,4706861,2799,1000,1799,1899.5
clown,TRUE,4706770,2513,798,1715,1655.5
aread,FALSE,4706374,3172,866,2306,2019
umbra,TRUE,4706170,2768,344,2424,1556
hefty,TRUE,4705898,2726,839,1887,1782.5
hongi,FALSE,4705721,2549,574,1975,1561.5
yiked,FALSE,4705698,2692,656,2036,1674
sents,FALSE,4705633,2891,922,1969,1906.5
lunch,TRUE,4705399,2482,704,1778,1593
cubit,FALSE,4704630,2486,852,1634,1669
wagon,TRUE,4704600,2626,716,1910,1671
porgy,FALSE,4704464,2573,1024,1549,1798.5
suers,FALSE,4704459,2968,917,2051,1942.5
spaes,FALSE,4704369,2929,1088,1841,2008.5
sized,FALSE,4703702,2726,1015,1711,1870.5
craic,FALSE,4703008.5,2841,961,1880,1901
ernes,FALSE,4702642,3061,832,2229,1946.5
reens,FALSE,4702453.5,3061,742,2319,1901.5
gripy,FALSE,4702425,2547,1062,1485,1804.5
beigy,FALSE,4702394,2687,1121,1566,1904
prore,FALSE,4701950,2912,1229,1683,2070.5
hylic,FALSE,4701711,2539,393,2146,1466
vimen,FALSE,4701439,2700,754,1946,1727
atoll,TRUE,4701375,2897,780,2117,1838.5
doole,FALSE,4701337,2747,1220,1527,1983.5
flabs,FALSE,4701289,2649,704,1945,1676.5
seder,FALSE,4701283,2881,1213,1668,2047
areca,FALSE,4701281,3250,801,2449,2025.5
looey,FALSE,4700960,2794,1293,1501,2043.5
wolve,FALSE,4700871,2720,944,1776,1832
blind,TRUE,4700795,2482,940,1542,1711
gynos,FALSE,4700358,2558,445,2113,1501.5
kinda,FALSE,4699984,2678,494,2184,1586
nonet,FALSE,4699943,2946,1026,1920,1986
rests,FALSE,4699837,3178,602,2576,1890
grund,FALSE,4699449,2514,847,1667,1680.5
joint,TRUE,4699134,2564,1000,1564,1782
icier,FALSE,4698496,2988,870,2118,1929
scoug,FALSE,4698431,2496,773,1723,1634.5
fango,FALSE,4698125,2639,713,1926,1676
whist,FALSE,4697954,2505,917,1588,1711
atilt,FALSE,4697532,2871,899,1972,1885
linen,TRUE,4697266.5,2901,877,2024,1889
remix,FALSE,4696937,2875,574,2301,1724.5
detox,TRUE,4696819,2803,604,2199,1703.5
bachs,FALSE,4696690,2621,597,2024,1609
adsum,FALSE,4696452,2652,365,2287,1508.5
galvo,FALSE,4696205,2679,635,2044,1657
silky,TRUE,4695981,2532,1099,1433,1815.5
wyted,FALSE,4695721,2704,653,2051,1678.5
pawns,FALSE,4695482,2617,690,1927,1653.5
human,TRUE,4695171,2593,609,1984,1601
filth,TRUE,4695058,2548,728,1820,1638
brisk,TRUE,4694962,2571,990,1581,1780.5
gipon,FALSE,4694667,2516,637,1879,1576.5
pumas,FALSE,4694627,2628,588,2040,1608
capex,FALSE,4694574,2796,886,1910,1841
locum,FALSE,4694530,2524,547,1977,1535.5
forms,FALSE,4694356,2633,682,1951,1657.5
order,TRUE,4694155,2936,913,2023,1924.5
corky,FALSE,4693525,2577,1059,1518,1818
frize,FALSE,4693402,2782,1113,1669,1947.5
empty,TRUE,4692642,2784,671,2113,1727.5
stoor,FALSE,4692527,2795,1031,1764,1913
roded,FALSE,4692504.5,2936,895,2041,1915.5
gorge,TRUE,4692393.5,2866,1057,1809,1961.5
watch,TRUE,4692105,2597,789,1808,1693
gloms,FALSE,4691984,2537,664,1873,1600.5
vends,FALSE,4691780,2743,529,2214,1636
quirt,FALSE,4691650,2637,880,1757,1758.5
major,TRUE,4691389,2744,758,1986,1751
prese,FALSE,4691333.5,2857,1181,1676,2019
pombe,FALSE,4690877,2640,930,1710,1785
sajou,FALSE,4690840,2684,806,1878,1745
fisty,FALSE,4690250,2556,921,1635,1738.5
shack,TRUE,4689721,2556,1082,1474,1819
peter,FALSE,4689704,2906,1025,1881,1965.5
hongs,FALSE,4689227,2520,599,1921,1559.5
vibes,FALSE,4689050,2737,656,2081,1696.5
pitch,TRUE,4688772,2487,746,1741,1616.5
hoxes,FALSE,4688598,2763,714,2049,1738.5
musha,FALSE,4688507,2661,465,2196,1563
barre,FALSE,4687834,3069,1216,1853,2142.5
circa,TRUE,4687593,2841,779,2062,1810
pygal,FALSE,4687501,2620,551,2069,1585.5
vardy,FALSE,4687391,2682,943,1739,1812.5
dunam,FALSE,4687260,2584,641,1943,1612.5
fremd,FALSE,4686467,2768,766,2002,1767
gaspy,FALSE,4686367,2590,913,1677,1751.5
sered,FALSE,4686256,2881,1207,1674,2044
teels,FALSE,4686127.5,2989,766,2223,1877.5
piper,TRUE,4686069,2886,932,1954,1909
skyed,FALSE,4686016,2663,841,1822,1752
forze,FALSE,4685524,2808,1022,1786,1915
bekah,FALSE,4685432,2813,729,2084,1771
casky,FALSE,4685345,2594,1001,1593,1797.5
pixel,TRUE,4685070,2734,830,1904,1782
shrub,TRUE,4684998,2558,766,1792,1662
ranas,FALSE,4684369,2914,747,2167,1830.5
wilga,FALSE,4683679,2698,537,2161,1617.5
curdy,FALSE,4683553,2529,980,1549,1754.5
pikey,FALSE,4683380,2668,1038,1630,1853
gloze,FALSE,4683152,2712,1004,1708,1858
slunk,TRUE,4682936,2475,1027,1448,1751
dongs,FALSE,4682492,2511,641,1870,1576
eathe,FALSE,4682278,3011,939,2072,1975
haiku,FALSE,4682123,2594,695,1899,1644.5
doxes,FALSE,4681863,2754,756,1998,1755
sasin,FALSE,4681858,2724,1038,1686,1881
azoic,FALSE,4681751,2712,576,2136,1644
treed,FALSE,4681681.5,2930,1029,1901,1979.5
pavin,FALSE,4681658,2601,783,1818,1692
gowan,FALSE,4681611,2626,713,1913,1669.5
sprug,FALSE,4681560,2558,713,1845,1635.5
zesty,TRUE,4681540,2793,828,1965,1810.5
blaws,FALSE,4681406,2636,742,1894,1689
typic,FALSE,4680705,2525,419,2106,1472
gerle,FALSE,4680626,2841,1106,1735,1973.5
quota,TRUE,4680428,2735,656,2079,1695.5
aorta,TRUE,4680058,3086,786,2300,1936
feuds,FALSE,4679907,2708,648,2060,1678
limps,FALSE,4679877,2557,437,2120,1497
tells,FALSE,4679839,2989,701,2288,1845
suete,FALSE,4679730.5,2798,1292,1506,2045
salol,FALSE,4679700,2848,1070,1778,1959
blips,FALSE,4679455,2526,726,1800,1626
swith,FALSE,4679306,2505,954,1551,1729.5
vowel,TRUE,4679282,2720,822,1898,1771
naras,FALSE,4679223,2914,703,2211,1808.5
papes,FALSE,4679069,2929,858,2071,1893.5
fikes,FALSE,4678090,2730,704,2026,1717
jelab,FALSE,4677940,2907,548,2359,1727.5
ladle,TRUE,4677716,2983,1053,1930,2018
steen,FALSE,4677595.5,2891,1068,1823,1979.5
dozes,FALSE,4677341,2752,755,1997,1753.5
tough,TRUE,4677304,2476,808,1668,1642
gaucy,FALSE,4677201,2531,1100,1431,1815.5
putid,FALSE,4676530,2487,715,1772,1601
merle,FALSE,4676354,2839,1098,1741,1968.5
woman,TRUE,4676204,2624,716,1908,1670
lenes,FALSE,4676017,2872,823,2049,1847.5
axmen,FALSE,4676011,2850,664,2186,1757
turfy,FALSE,4675992,2585,897,1688,1741
cahow,FALSE,4675925,2603,660,1943,1631.5
bidon,FALSE,4675767,2507,712,1795,1609.5
unfit,TRUE,4675451,2528,556,1972,1542
oulks,FALSE,4675347,2598,430,2168,1514
skive,FALSE,4675210,2672,1112,1560,1892
lushy,FALSE,4675124,2519,746,1773,1632.5
wyled,FALSE,4675037,2685,654,2031,1669.5
moxie,FALSE,4675011,2711,980,1731,1845.5
subha,FALSE,4674982,2630,701,1929,1665.5
lered,FALSE,4674774,2911,929,1982,1920
swang,FALSE,4674765,2571,940,1631,1755.5
dedal,FALSE,4674696,2983,747,2236,1865
total,TRUE,4674358,2897,858,2039,1877.5
kaput,FALSE,4674232,2581,717,1864,1649
swoun,FALSE,4674000,2492,866,1626,1679
rejig,FALSE,4673863,2867,549,2318,1708
budas,FALSE,4673715,2621,633,1988,1627
fubar,FALSE,4673548,2677,754,1923,1715.5
mouth,TRUE,4673493,2474,829,1645,1651.5
varve,FALSE,4673444,2951,980,1971,1965.5
scurf,FALSE,4673268,2567,749,1818,1658
pukes,FALSE,4672746,2679,694,1985,1686.5
metre,FALSE,4672596,2858,1036,1822,1947
bapus,FALSE,4672584,2597,653,1944,1625
wrong,TRUE,4672550,2554,817,1737,1685.5
taxus,FALSE,4672512,2688,583,2105,1635.5
dhuti,FALSE,4672069,2520,570,1950,1545
gaums,FALSE,4671439,2582,688,1894,1635
hyoid,FALSE,4671248,2486,612,1874,1549
kugel,FALSE,4671245,2663,747,1916,1705
quats,FALSE,4671118,2680,691,1989,1685.5
meane,FALSE,4671052,2813,1262,1551,2037.5
blank,TRUE,4670618,2576,976,1600,1776
siens,FALSE,4670553,2871,963,1908,1917
quant,FALSE,4670496,2612,951,1661,1781.5
chyme,FALSE,4670396,2598,863,1735,1730.5
knaps,FALSE,4670137,2625,500,2125,1562.5
divan,FALSE,4670121,2625,655,1970,1640
peghs,FALSE,4670115,2699,515,2184,1607
jagir,FALSE,4670045,2720,761,1959,1740.5
venom,TRUE,4669959,2726,598,2128,1662
balks,FALSE,4669909,2644,680,1964,1662
plush,TRUE,4669878,2448,818,1630,1633
mousy,FALSE,4669722,2463,1086,1377,1774.5
bawls,FALSE,4669540,2636,701,1935,1668.5
pingo,FALSE,4669467,2516,617,1899,1566.5
netes,FALSE,4669305,2891,744,2147,1817.5
worms,FALSE,4669031,2620,629,1991,1624.5
swopt,FALSE,4668826,2498,957,1541,1727.5
cowry,FALSE,4668714,2569,1019,1550,1794
bendy,FALSE,4668626,2660,987,1673,1823.5
ablow,FALSE,4668383,2691,418,2273,1554.5
viced,FALSE,4668320,2670,737,1933,1703.5
algum,FALSE,4668190,2612,533,2079,1572.5
pilch,FALSE,4668088,2468,747,1721,1607.5
poked,FALSE,4667914,2647,869,1778,1758
russe,FALSE,4667753.5,2968,966,2002,1967
usure,FALSE,4667723,2968,790,2178,1879
eager,TRUE,4667460,3102,973,2129,2037.5
sarus,FALSE,4667432,2821,951,1870,1886
chace,FALSE,4667349,2792,1225,1567,2008.5
gibed,FALSE,4667221,2640,810,1830,1725
almug,FALSE,4666903,2612,526,2086,1569
hiked,FALSE,4666900,2654,719,1935,1686.5
gandy,FALSE,4666805,2546,991,1555,1768.5
ruler,TRUE,4666114,2998,933,2065,1965.5
comus,FALSE,4665985,2494,656,1838,1575
grown,TRUE,4665842,2554,781,1773,1667.5
rumpo,FALSE,4665791,2611,460,2151,1535.5
amply,TRUE,4664972,2618,763,1855,1690.5
wifes,FALSE,4664565,2722,664,2058,1693
swive,FALSE,4664538,2664,1146,1518,1905
bribe,TRUE,4664520,2807,1154,1653,1980.5
knowe,FALSE,4664410,2675,800,1875,1737.5
toros,FALSE,4664346,2795,759,2036,1777
drouk,FALSE,4664156,2539,817,1722,1678
aloos,FALSE,4663420,2848,754,2094,1801
vetch,FALSE,4663228,2699,687,2012,1693
oping,FALSE,4663024,2516,591,1925,1553.5
hemps,FALSE,4662921,2697,458,2239,1577.5
jaunt,TRUE,4662860,2610,924,1686,1767
helix,TRUE,4662850,2767,589,2178,1678
shtik,FALSE,4662835,2513,892,1621,1702.5
glims,FALSE,4662784,2511,686,1825,1598.5
gauze,TRUE,4662607,2757,1028,1729,1892.5
vigor,TRUE,4662553,2606,656,1950,1631
eking,TRUE,4662485,2755,571,2184,1663
panne,FALSE,4662450.5,2861,1191,1670,2026
knife,TRUE,4661887,2662,832,1830,1747
daych,FALSE,4661603,2523,735,1788,1629
licks,FALSE,4661559,2563,437,2126,1500
plack,FALSE,4661464,2553,915,1638,1734
satai,FALSE,4660948,2841,955,1886,1898
braky,FALSE,4660891,2632,1166,1466,1899
recco,FALSE,4660494,3014,613,2401,1813.5
patte,FALSE,4660404,2978,1120,1858,2049
jolts,FALSE,4659462,2633,586,2047,1609.5
hijra,FALSE,4659408,2799,490,2309,1644.5
talas,FALSE,4659190,2842,764,2078,1803
sains,FALSE,4658896,2724,1154,1570,1939
alant,FALSE,4658820,2774,1084,1690,1929
fonly,FALSE,4658589,2495,1080,1415,1787.5
vouge,FALSE,4658566,2635,987,1648,1811
serge,FALSE,4658405,2811,1271,1540,2041
cubed,FALSE,4657788,2598,877,1721,1737.5
toxin,TRUE,4657784,2574,728,1846,1651
nance,FALSE,4657659,2963,1056,1907,2009.5
stunk,TRUE,4657519,2494,903,1591,1698.5
itchy,TRUE,4657382,2558,559,1999,1558.5
drubs,FALSE,4657307,2549,603,1946,1576
ridgy,FALSE,4657089,2571,822,1749,1696.5
forex,FALSE,4656658,2810,904,1906,1857
fogey,FALSE,4656061,2653,1164,1489,1908.5
fibro,FALSE,4655826,2631,605,2026,1618
towny,FALSE,4655716,2501,1000,1501,1750.5
thewy,FALSE,4655526,2713,859,1854,1786
hoiks,FALSE,4655277,2519,705,1814,1612
erode,TRUE,4655237,2936,1076,1860,2006
quais,FALSE,4654968,2660,710,1950,1685
skelf,FALSE,4654821,2731,741,1990,1736
hound,TRUE,4654524,2429,813,1616,1621
tecta,FALSE,4654488,3080,650,2430,1865
timbo,FALSE,4654391,2552,494,2058,1523
woken,TRUE,4654323,2675,822,1853,1748.5
ricer,FALSE,4653808,2988,893,2095,1940.5
yolks,FALSE,4653781,2558,488,2070,1523
yowls,FALSE,4653412,2550,509,2041,1529.5
colza,FALSE,4653390,2713,673,2040,1693
reave,FALSE,4653241,2951,1124,1827,2037.5
magus,FALSE,4653142,2582,596,1986,1589
leets,FALSE,4652885.5,2989,682,2307,1835.5
cella,FALSE,4651793,3061,778,2283,1919.5
foids,FALSE,4651663,2515,786,1729,1650.5
thuds,FALSE,4651385,2491,563,1928,1527
cromb,FALSE,4651272,2523,788,1735,1655.5
snick,FALSE,4650842,2465,984,1481,1724.5
faked,FALSE,4650666,2744,888,1856,1816
chefs,FALSE,4650661,2708,590,2118,1649
unwit,FALSE,4650387,2515,557,1958,1536
gotch,FALSE,4650211,2467,796,1671,1631.5
crowd,TRUE,4650019,2522,852,1670,1687
taits,FALSE,4649708,2841,894,1947,1867.5
kibla,FALSE,4649420,2673,505,2168,1589
aking,FALSE,4648475,2608,640,1968,1624
firms,FALSE,4648450,2607,605,2002,1606
brows,FALSE,4647493,2589,745,1844,1667
naira,FALSE,4647210,2943,823,2120,1883
crunk,FALSE,4647087,2494,925,1569,1709.5
shtup,FALSE,4646864,2467,759,1708,1613
aedes,FALSE,4646759,2953,812,2141,1882.5
morph,TRUE,4646621,2533,738,1795,1635.5
stens,FALSE,4646113,2891,838,2053,1864.5
leper,TRUE,4646004,2887,918,1969,1902.5
saola,FALSE,4645399,2848,1140,1708,1994
poncy,FALSE,4645279,2434,1076,1358,1755
mixte,FALSE,4645255,2705,884,1821,1794.5
stirs,FALSE,4645048,2769,897,1872,1833
sheer,TRUE,4644769.5,2890,1217,1673,2053.5
misgo,FALSE,4644635,2536,523,2013,1529.5
hecks,FALSE,4644603,2703,458,2245,1580.5
xenic,FALSE,4644458,2738,570,2168,1654
curfs,FALSE,4644450,2567,618,1949,1592.5
globi,FALSE,4644420,2535,595,1940,1565
pongs,FALSE,4644335,2487,672,1815,1579.5
gauje,FALSE,4644333,2749,1010,1739,1879.5
gleby,FALSE,4644331,2688,881,1807,1784.5
gismo,FALSE,4644089,2536,523,2013,1529.5
sulph,FALSE,4643916,2448,853,1595,1650.5
poxes,FALSE,4643706,2730,787,1943,1758.5
ycond,FALSE,4643522,2458,590,1868,1524
deads,FALSE,4643451,2953,765,2188,1859
wring,TRUE,4643350,2528,839,1689,1683.5
hings,FALSE,4643321,2494,522,1972,1508
speck,TRUE,4643015,2670,869,1801,1769.5
kubie,FALSE,4642694,2629,845,1784,1737
merse,FALSE,4642589,2809,1107,1702,1958
toses,FALSE,4642369,3014,862,2152,1938
mirks,FALSE,4642146,2602,563,2039,1582.5
yaars,FALSE,4642130,2781,805,1976,1793
mould,FALSE,4642115,2446,831,1615,1638.5
sough,FALSE,4641884,2427,1025,1402,1726
guyed,FALSE,4641579,2600,766,1834,1683
sants,FALSE,4641115,2744,984,1760,1864
flask,TRUE,4641009,2584,928,1656,1756
confs,FALSE,4640861,2496,687,1809,1591.5
surfy,FALSE,4640572,2536,1114,1422,1825
quasi,TRUE,4640187,2660,698,1962,1679
ghoul,TRUE,4639925,2457,741,1716,1599
joker,TRUE,4639788,2795,841,1954,1818
ankhs,FALSE,4639749,2658,304,2354,1481
vogue,TRUE,4639723,2635,895,1740,1765
looed,FALSE,4639588,2747,1047,1700,1897
regie,FALSE,4639470,2840,996,1844,1918
fribs,FALSE,4638176,2576,729,1847,1652.5
decks,FALSE,4637868,2694,500,2194,1597
awing,FALSE,4637803,2600,674,1926,1637
briks,FALSE,4637505,2571,797,1774,1684
mavis,FALSE,4637267,2621,654,1967,1637.5
blawn,FALSE,4637058,2568,836,1732,1702
caaed,FALSE,4636784,2783,1245,1538,2014
jarps,FALSE,4636610,2737,573,2164,1655
dings,FALSE,4636586,2485,564,1921,1524.5
zoned,FALSE,4636341,2684,857,1827,1770.5
tasso,FALSE,4635931.5,2867,762,2105,1814.5
stent,FALSE,4635491,2891,1055,1836,1973
scars,FALSE,4635464,2812,901,1911,1856.5
cymol,FALSE,4635413,2484,570,1914,1527
joram,FALSE,4635326,2744,667,2077,1705.5
wigan,FALSE,4634886,2600,645,1955,1622.5
yogic,FALSE,4634836,2485,541,1944,1513
apple,TRUE,4634643.5,2959,846,2113,1902.5
caxon,FALSE,4634304,2617,776,1841,1696.5
exams,FALSE,4634232,2918,497,2421,1707.5
blogs,FALSE,4634105,2506,730,1776,1618
eisel,FALSE,4633629,2969,828,2141,1898.5
gauch,FALSE,4633547,2493,875,1618,1684
fixer,TRUE,4633458,2784,880,1904,1832
conks,FALSE,4633396,2491,707,1784,1599
kench,FALSE,4633349,2635,692,1943,1663.5
thawy,FALSE,4633307,2566,989,1577,1777.5
biogs,FALSE,4633128,2505,731,1774,1618
tenue,FALSE,4633088,2730,1036,1694,1883
babes,FALSE,4633020,2850,888,1962,1869
dozen,TRUE,4632993,2684,849,1835,1766.5
rocky,TRUE,4632975,2577,859,1718,1718
furth,FALSE,4632184,2547,763,1784,1655
nuked,FALSE,4631923,2635,671,1964,1653
bourg,FALSE,4631681,2534,810,1724,1672
preop,FALSE,4631617,2912,774,2138,1843
sheas,FALSE,4630977,2962,886,2076,1924
crwth,FALSE,4630746,2525,769,1756,1647
lough,FALSE,4630402,2457,747,1710,1602
wefts,FALSE,4630391,2742,525,2217,1633.5
forbs,FALSE,4630298,2602,638,1964,1620
kalif,FALSE,4630208,2613,620,1993,1616.5
borks,FALSE,4629627,2597,706,1891,1651.5
tombs,FALSE,4629259,2523,549,1974,1536
koban,FALSE,4629246,2601,649,1952,1625
wisht,FALSE,4629089,2505,646,1859,1575.5
chops,FALSE,4629014,2464,672,1792,1568
crazy,TRUE,4628918,2646,1156,1490,1901
aswim,FALSE,4628838,2666,383,2283,1524.5
urdee,FALSE,4628642,2720,1117,1603,1918.5
unfed,TRUE,4628609,2640,581,2059,1610.5
minds,FALSE,4628585,2483,553,1930,1518
amate,FALSE,4628099,2930,1049,1881,1989.5
fancy,TRUE,4628031,2531,1095,1436,1813
globs,FALSE,4627926,2506,620,1886,1563
porer,FALSE,4627452,2912,1114,1798,2013
undam,FALSE,4627374,2584,400,2184,1492
fangs,FALSE,4627087,2584,691,1893,1637.5
loess,FALSE,4626976.5,2995,751,2244,1873
passe,FALSE,4626511.5,2929,1121,1808,2025
haufs,FALSE,4626468,2570,609,1961,1589.5
faxes,FALSE,4626458,2827,806,2021,1816.5
doups,FALSE,4626449,2464,641,1823,1552.5
hirer,FALSE,4626438,2919,964,1955,1941.5
pyoid,FALSE,4626356,2453,685,1768,1569
donee,FALSE,4625763,2649,1271,1378,1960
gobis,FALSE,4625709,2505,645,1860,1575
divot,FALSE,4625555,2506,747,1759,1626.5
hokis,FALSE,4625388,2519,554,1965,1536.5
waked,FALSE,4625341,2731,835,1896,1783
agate,TRUE,4625109,2932,1023,1909,1977.5
sages,FALSE,4624927,2883,1091,1792,1987
frush,FALSE,4624861,2498,878,1620,1688
suras,FALSE,4624766,2821,914,1907,1867.5
joeys,FALSE,4624401,2791,515,2276,1653
antar,FALSE,4624174,2963,714,2249,1838.5
emyds,FALSE,4624133,2759,244,2515,1501.5
addle,FALSE,4624099.5,2983,822,2161,1902.5
chews,FALSE,4623984,2695,580,2115,1637.5
wench,TRUE,4623570,2627,755,1872,1691
twiny,FALSE,4623498,2475,1005,1470,1740
torso,TRUE,4623335,2795,820,1975,1807.5
grimy,TRUE,4623057,2499,1080,1419,1789.5
glift,FALSE,4622714,2469,870,1599,1669.5
gutsy,FALSE,4622160,2459,947,1512,1703
piked,FALSE,4622008,2621,792,1829,1706.5
fazes,FALSE,4621936,2825,805,2020,1815
kawed,FALSE,4621856,2731,786,1945,1758.5
dowts,FALSE,4621539,2522,591,1931,1556.5
punty,FALSE,4620999,2437,970,1467,1703.5
juice,TRUE,4620850,2635,1048,1587,1841.5
heres,FALSE,4620724,2890,828,2062,1859
sames,FALSE,4620339,2881,1085,1796,1983
eyrie,FALSE,4619734,2957,840,2117,1898.5
direr,FALSE,4619703,2910,1006,1904,1958
burds,FALSE,4619655,2549,627,1922,1588
pashm,FALSE,4619392,2550,596,1954,1573
etape,FALSE,4619388,2978,930,2048,1954
gybes,FALSE,4618975,2658,549,2109,1603.5
yacks,FALSE,4618883,2594,457,2137,1525.5
arsis,FALSE,4618867,3011,682,2329,1846.5
cuing,FALSE,4618815,2402,873,1529,1637.5
hykes,FALSE,4618654,2672,458,2214,1565
music,TRUE,4618602,2468,562,1906,1515
gages,FALSE,4618361,2883,840,2043,1861.5
synch,FALSE,4617897,2412,819,1593,1615.5
roons,FALSE,4617888,2678,846,1832,1762
sozin,FALSE,4617842,2523,944,1579,1733.5
repel,TRUE,4617836,2887,879,2008,1883
barky,FALSE,4617669,2632,1059,1573,1845.5
phuts,FALSE,4617418,2467,626,1841,1546.5
sayst,FALSE,4617336.5,2611,1123,1488,1867
doubt,TRUE,4617283,2434,832,1602,1633
wonga,FALSE,4617216,2626,641,1985,1633.5
shaky,TRUE,4617099,2525,1236,1289,1880.5
unked,FALSE,4616809,2635,568,2067,1601.5
mynah,FALSE,4616666,2553,571,1982,1562
demob,FALSE,4616524,2664,557,2107,1610.5
compt,FALSE,4616463,2432,841,1591,1636.5
frack,FALSE,4616447,2603,975,1628,1789
soces,FALSE,4616202,2795,1055,1740,1925
gravy,TRUE,4616149,2612,1099,1513,1855.5
bonds,FALSE,4616066,2478,696,1782,1587
rotos,FALSE,4615878,2795,663,2132,1729
azoth,FALSE,4615662,2663,665,1998,1664
talls,FALSE,4615321,2842,763,2079,1802.5
bunya,FALSE,4615311,2600,565,2035,1582.5
gormy,FALSE,4615179,2525,989,1536,1757
whios,FALSE,4614989,2511,661,1850,1586
holks,FALSE,4614983,2520,551,1969,1535.5
divna,FALSE,4614979,2625,608,2017,1616.5
mulga,FALSE,4614921,2612,545,2067,1578.5
begun,TRUE,4614887,2630,694,1936,1662
unsex,FALSE,4614621,2718,526,2192,1622
howls,FALSE,4614614,2512,572,1940,1542
viold,FALSE,4614454,2487,769,1718,1628
guild,TRUE,4614163,2422,847,1575,1634.5
deres,FALSE,4613989,2881,870,2011,1875.5
jilts,FALSE,4613556,2607,509,2098,1558
wreck,TRUE,4613341,2737,792,1945,1764.5
pratt,FALSE,4613136,2759,1108,1651,1933.5
nisse,FALSE,4613112.5,2871,914,1957,1892.5
bisom,FALSE,4612246,2503,629,1874,1566
chirk,FALSE,4612131,2513,873,1640,1693
culms,FALSE,4612080,2469,600,1869,1534.5
dykes,FALSE,4611919,2663,500,2163,1581.5
cajon,FALSE,4611566,2607,767,1840,1687
kangs,FALSE,4611541,2579,575,2004,1577
boing,FALSE,4611457,2437,941,1496,1689
folds,FALSE,4611369,2516,632,1884,1574
hoved,FALSE,4611334,2627,833,1794,1730
bousy,FALSE,4611297,2432,1152,1280,1792
kohls,FALSE,4611178,2520,506,2014,1513
whits,FALSE,4611119,2505,668,1837,1586.5
trapt,FALSE,4610998,2759,1026,1733,1892.5
exuls,FALSE,4610892,2816,449,2367,1632.5
hazed,FALSE,4610746,2749,820,1929,1784.5
buhrs,FALSE,4610568,2558,556,2002,1557
pilow,FALSE,4610537,2508,605,1903,1556.5
covin,FALSE,4610350,2467,814,1653,1640.5
oxime,FALSE,4610306,2711,813,1898,1762
farer,FALSE,4610204,3009,1133,1876,2071
slues,FALSE,4610191,2779,1086,1693,1932.5
pound,TRUE,4609632,2396,886,1510,1641
oundy,FALSE,4609546,2467,799,1668,1633
payee,TRUE,4609427,2728,1217,1511,1972.5
borax,TRUE,4609188,2723,786,1937,1754.5
stowp,FALSE,4608579,2498,768,1730,1633
utter,TRUE,4608538,3017,751,2266,1884
regar,FALSE,4608421,3102,789,2313,1945.5
sophy,FALSE,4608278,2433,1095,1338,1764
dowls,FALSE,4607879,2503,614,1889,1558.5
mimer,FALSE,4607715,2838,900,1938,1869
brink,TRUE,4607505,2503,1001,1502,1752
limbo,TRUE,4607489,2533,433,2100,1483
ziram,FALSE,4607400,2726,573,2153,1649.5
grese,FALSE,4606866.5,2811,1154,1657,1982.5
album,TRUE,4606865,2579,523,2056,1551
mawns,FALSE,4606743,2569,655,1914,1612
lynch,TRUE,4606415,2442,541,1901,1491.5
trots,FALSE,4606210,2795,835,1960,1815
clung,TRUE,4606110,2403,787,1616,1595
ouija,FALSE,4604992,2713,559,2154,1636
agoge,FALSE,4604946,2938,897,2041,1917.5
bowrs,FALSE,4604816,2589,666,1923,1627.5
colby,FALSE,4604562,2453,977,1476,1715
stivy,FALSE,4604396,2498,1119,1379,1808.5
gitch,FALSE,4604305,2441,719,1722,1580
bandy,FALSE,4604108,2513,1049,1464,1781
kelpy,FALSE,4604038,2669,788,1881,1728.5
nowty,FALSE,4603931,2501,845,1656,1673
aware,TRUE,4603825,2996,1068,1928,2032
unwed,TRUE,4603545,2627,582,2045,1604.5
peace,TRUE,4603473,2759,1267,1492,2013
haars,FALSE,4603332,2743,868,1875,1805.5
brown,TRUE,4603145,2521,839,1682,1680
fidos,FALSE,4603049,2515,581,1934,1548
buaze,FALSE,4603030,2724,1110,1614,1917
query,TRUE,4602995,2796,902,1894,1849
dorad,FALSE,4602604.5,2789,834,1955,1811.5
chaws,FALSE,4601765,2548,710,1838,1629
wangs,FALSE,4601762,2571,638,1933,1604.5
tools,FALSE,4601562,2606,870,1736,1738
reney,FALSE,4601527,2860,1168,1692,2014
wiped,FALSE,4601325,2613,779,1834,1696
diazo,FALSE,4601189,2634,698,1936,1666
waxes,FALSE,4601133,2814,753,2061,1783.5
meter,TRUE,4600965,2858,990,1868,1924
pepla,FALSE,4600783,2959,668,2291,1813.5
gusty,TRUE,4600439,2459,884,1575,1671.5
unsee,FALSE,4600408,2681,942,1739,1811.5
mitch,FALSE,4600033,2439,711,1728,1575
mvule,FALSE,4599953,2608,873,1735,1740.5
chips,FALSE,4599814,2438,694,1744,1566
pecks,FALSE,4599711,2670,531,2139,1600.5
bedim,FALSE,4599621,2638,690,1948,1664
appel,FALSE,4599379.5,2959,734,2225,1846.5
think,TRUE,4599133,2445,854,1591,1649.5
cases,FALSE,4598869,3031,936,2095,1983.5
glibs,FALSE,4598726,2480,642,1838,1561
bigos,FALSE,4598451,2505,610,1895,1557.5
pings,FALSE,4598429,2461,595,1866,1528
prick,TRUE,4598351,2480,940,1540,1710
ought,TRUE,4598131,2476,575,1901,1525.5
kevil,FALSE,4598018,2702,625,2077,1663.5
bhuna,FALSE,4597808,2562,728,1834,1645
pixes,FALSE,4597800,2704,710,1994,1707
snell,FALSE,4597741,2872,948,1924,1910
tumid,FALSE,4597277,2439,672,1767,1555.5
kynde,FALSE,4596764,2595,675,1920,1635
kiefs,FALSE,4596713,2730,470,2260,1600
urari,FALSE,4596652,2850,770,2080,1810
micht,FALSE,4596487,2439,646,1793,1542.5
wodge,FALSE,4596450,2593,937,1656,1765
redid,FALSE,4596274.5,2910,698,2212,1804
musty,TRUE,4596167,2457,876,1581,1666.5
hakus,FALSE,4595768,2565,503,2062,1534
knags,FALSE,4595587,2579,526,2053,1552.5
loses,FALSE,4595467,2995,801,2194,1898
motif,TRUE,4594947,2492,681,1811,1586.5
fumes,FALSE,4594933,2636,737,1899,1686.5
rumps,FALSE,4594753,2556,438,2118,1497
rodeo,TRUE,4594715,2936,835,2101,1885.5
pithy,TRUE,4594590,2456,847,1609,1651.5
hizen,FALSE,4593822,2667,730,1937,1698.5
lapel,TRUE,4593654,2959,924,2035,1941.5
atria,FALSE,4593562,3060,603,2457,1831.5
phang,FALSE,4593539,2484,816,1668,1650
pizes,FALSE,4593278,2702,709,1993,1705.5
yupon,FALSE,4593250,2443,512,1931,1477.5
faiks,FALSE,4593137,2583,797,1786,1690
warby,FALSE,4593015,2624,938,1686,1781
mavin,FALSE,4592919,2553,748,1805,1650.5
balmy,TRUE,4592764,2539,1021,1518,1780
nighs,FALSE,4592198,2494,370,2124,1432
welks,FALSE,4592036,2718,528,2190,1623
hiply,FALSE,4591904,2437,855,1582,1646
damps,FALSE,4591668,2541,562,1979,1551.5
flops,FALSE,4591589,2492,667,1825,1579.5
chimo,FALSE,4591484,2445,734,1711,1589.5
punga,FALSE,4591291,2562,607,1955,1584.5
puree,TRUE,4591195,2696,1233,1463,1964.5
conne,FALSE,4591142.5,2727,1222,1505,1974.5
wrack,TRUE,4591122,2590,922,1668,1756
kofta,FALSE,4591106,2658,527,2131,1592.5
chank,FALSE,4590977,2488,944,1544,1716
rearm,TRUE,4590624,3100,848,2252,1974
lasso,TRUE,4589029.5,2848,701,2147,1774.5
snowy,TRUE,4588208,2452,1086,1366,1769
wanze,FALSE,4588112,2744,970,1774,1857
cense,FALSE,4587933,2672,1174,1498,1923
ojime,FALSE,4587524,2701,801,1900,1751
botch,TRUE,4587514,2434,854,1580,1644
pivot,TRUE,4587398,2482,778,1704,1630
dizen,FALSE,4587087,2658,772,1886,1715
jakes,FALSE,4586882,2812,690,2122,1751
flews,FALSE,4586559,2723,575,2148,1649
axoid,FALSE,4586536,2636,675,1961,1655.5
gecko,TRUE,4586282,2679,526,2153,1602.5
wolds,FALSE,4586044,2503,579,1924,1541
vigas,FALSE,4585839,2623,511,2112,1567
greet,TRUE,4585630.5,2860,1130,1730,1995
piezo,FALSE,4585251,2757,599,2158,1678
wavey,FALSE,4585241,2725,1118,1607,1921.5
jours,FALSE,4585098,2612,652,1960,1632
gnaws,FALSE,4585071,2571,570,2001,1570.5
kaifs,FALSE,4585056,2583,661,1922,1622
seams,FALSE,4584720,2881,1019,1862,1950
domic,FALSE,4584715,2436,640,1796,1538
horah,FALSE,4584558,2798,813,1985,1805.5
boeuf,FALSE,4584075,2660,737,1923,1698.5
birks,FALSE,4583721,2571,629,1942,1600
sinky,FALSE,4583612,2434,1126,1308,1780
flaks,FALSE,4583552,2584,735,1849,1659.5
imbed,FALSE,4583344,2638,565,2073,1601.5
nifty,FALSE,4583089,2488,767,1721,1627.5
fease,FALSE,4583018,2790,1280,1510,2035
lethe,FALSE,4582955,2750,893,1857,1821.5
cumin,TRUE,4582759,2400,733,1667,1566.5
remet,FALSE,4582371,2858,979,1879,1918.5
smowt,FALSE,4581323,2450,926,1524,1688
doted,FALSE,4581124.5,2766,937,1829,1851.5
knuts,FALSE,4581089,2494,447,2047,1470.5
tulle,TRUE,4580633,2828,1033,1795,1930.5
hayey,FALSE,4580530,2761,1084,1677,1922.5
natal,TRUE,4580477,2774,771,2003,1772.5
hacks,FALSE,4580085,2556,520,2036,1538
clomp,FALSE,4579941,2413,767,1646,1590
tsars,FALSE,4579551,3031,660,2371,1845.5
milch,FALSE,4579349,2420,712,1708,1566
terry,FALSE,4578958,2977,1070,1907,2023.5
sorns,FALSE,4578320,2678,1026,1652,1852
frisk,TRUE,4577896,2511,953,1558,1732
qorma,FALSE,4577212,2746,597,2149,1671.5
fives,FALSE,4576618,2677,741,1936,1709
burka,FALSE,4576583,2672,641,2031,1656.5
rucks,FALSE,4576435,2562,438,2124,1500
weamb,FALSE,4576385,2724,711,2013,1717.5
zibet,FALSE,4575914,2672,833,1839,1752.5
fidge,FALSE,4575869,2580,913,1667,1746.5
speer,FALSE,4575844.5,2857,1134,1723,1995.5
peres,FALSE,4575832,2857,901,1956,1879
clubs,FALSE,4575611,2438,624,1814,1531
plows,FALSE,4575444,2479,648,1831,1563.5
burps,FALSE,4575310,2525,608,1917,1566.5
waifs,FALSE,4575277,2575,724,1851,1649.5
culex,FALSE,4574382,2646,822,1824,1734
merel,FALSE,4574363,2839,986,1853,1912.5
redes,FALSE,4574363,2881,776,2105,1828.5
pesky,TRUE,4574189,2639,883,1756,1761
drees,FALSE,4573994.5,2881,909,1972,1895
kiths,FALSE,4573754,2513,397,2116,1455
dacks,FALSE,4573350,2547,562,1985,1554.5
butyl,FALSE,4573198,2456,629,1827,1542.5
javel,FALSE,4572680,2789,847,1942,1818
linky,FALSE,4572130,2464,848,1616,1656
awmry,FALSE,4571903,2655,762,1893,1708.5
matte,FALSE,4571665,2930,1085,1845,2007.5
roton,FALSE,4571530,2727,757,1970,1742
havoc,TRUE,4570563,2558,585,1973,1571.5
neons,FALSE,4570531.5,2897,741,2156,1819
pudge,FALSE,4570525,2529,903,1626,1716
eggar,FALSE,4570499.5,3102,526,2576,1814
lamby,FALSE,4570399,2539,841,1698,1690
sices,FALSE,4570296,2769,978,1791,1873.5
binds,FALSE,4570160,2452,619,1833,1535.5
polks,FALSE,4570091,2487,624,1863,1555.5
arnas,FALSE,4569478,2914,746,2168,1830
avize,FALSE,4569200,2796,866,1930,1831
aioli,FALSE,4569158,2877,760,2117,1818.5
torts,FALSE,4569132,2795,766,2029,1780.5
alary,FALSE,4569100,2811,1165,1646,1988
topaz,TRUE,4568944,2630,653,1977,1641.5
marvy,FALSE,4568655,2610,984,1626,1797
loots,FALSE,4568320,2606,786,1820,1696
leger,FALSE,4568137,2841,927,1914,1884
tanto,FALSE,4568083,2799,789,2010,1794
dunsh,FALSE,4568077,2374,746,1628,1560
abate,TRUE,4567985,2899,1027,1872,1963
ormer,FALSE,4567903,2864,899,1965,1881.5
nocks,FALSE,4567700,2491,463,2028,1477
ealed,FALSE,4567397,2983,924,2059,1953.5
lotta,FALSE,4567338,2897,681,2216,1789
yapok,FALSE,4567245,2547,613,1934,1580
hyped,FALSE,4567214,2568,586,1982,1577
butoh,FALSE,4567104,2443,741,1702,1592
bling,FALSE,4566528,2412,863,1549,1637.5
mowed,FALSE,4565911,2591,848,1743,1719.5
wafts,FALSE,4565873,2595,587,2008,1591
nones,FALSE,4565683,2897,809,2088,1853
cetes,FALSE,4565490,2789,905,1884,1847
hived,FALSE,4565428,2601,756,1845,1678.5
cosec,FALSE,4565372.5,2795,906,1889,1850.5
enure,FALSE,4565323,2900,900,2000,1900
brier,FALSE,4565022,2807,1236,1571,2021.5
peise,FALSE,4564922,2667,1245,1422,1956
teens,FALSE,4564905.5,2891,786,2105,1838.5
joins,FALSE,4564874,2515,783,1732,1649
plonk,FALSE,4564656,2419,882,1537,1650.5
flaws,FALSE,4564340,2576,705,1871,1640.5
withs,FALSE,4563975,2505,460,2045,1482.5
yodhs,FALSE,4563969,2457,424,2033,1440.5
octet,TRUE,4563904,2844,763,2081,1803.5
sabes,FALSE,4563602,2850,1081,1769,1965.5
dishy,FALSE,4563601,2431,785,1646,1608
allis,FALSE,4563370.5,2822,648,2174,1735
beret,TRUE,4562928,2827,1149,1678,1988
kypes,FALSE,4562858,2639,455,2184,1547
abele,FALSE,4562754.5,2880,920,1960,1900
leery,TRUE,4562543.5,2958,1023,1935,1990.5
flips,FALSE,4562389,2466,689,1777,1577.5
ardor,TRUE,4561809,2789,827,1962,1808
tents,FALSE,4561563,2891,705,2186,1798
lunks,FALSE,4561496,2475,504,1971,1489.5
llano,FALSE,4561446.5,2780,836,1944,1808
mucin,FALSE,4561191,2400,637,1763,1518.5
shtum,FALSE,4561168,2419,745,1674,1582
diode,TRUE,4560693,2746,1050,1696,1898
edify,TRUE,4560678,2697,757,1940,1727
duomi,FALSE,4560551,2445,620,1825,1532.5
bandh,FALSE,4560454,2475,824,1651,1649.5
doled,FALSE,4560440.5,2747,938,1809,1842.5
kidge,FALSE,4560323,2575,797,1778,1686
yesty,FALSE,4559507,2758,831,1927,1794.5
gerne,FALSE,4559404,2743,1126,1617,1934.5
shown,TRUE,4559353,2414,909,1505,1661.5
yitie,FALSE,4559326,2787,901,1886,1844
goxes,FALSE,4559239,2684,760,1924,1722
uptak,FALSE,4559224,2581,481,2100,1531
young,TRUE,4559055,2397,673,1724,1535
sownd,FALSE,4558924,2405,971,1434,1688
cress,TRUE,4557680.5,2959,849,2110,1904
pikau,FALSE,4557648,2561,520,2041,1540.5
banks,FALSE,4557540,2546,707,1839,1626.5
tarty,FALSE,4557174,2830,1119,1711,1974.5
harsh,TRUE,4557071,2743,846,1897,1794.5
nixed,FALSE,4556977,2660,687,1973,1673.5
eagle,TRUE,4556833,2913,1029,1884,1971
waxen,TRUE,4556785,2746,847,1899,1796.5
jedis,FALSE,4556339,2718,531,2187,1624.5
hilum,FALSE,4556142,2429,507,1922,1468
gothy,FALSE,4556029,2436,897,1539,1666.5
dorky,FALSE,4556008,2499,972,1527,1735.5
cozey,FALSE,4555918,2629,1170,1459,1899.5
elute,FALSE,4555757,2828,1001,1827,1914.5
pinch,TRUE,4555719,2370,774,1596,1572
mongs,FALSE,4555596,2439,637,1802,1538
orris,FALSE,4555499,2775,665,2110,1720
outby,FALSE,4554828,2481,726,1755,1603.5
chogs,FALSE,4554464,2418,698,1720,1558
newbs,FALSE,4554411,2685,365,2320,1525
flank,TRUE,4553552,2516,939,1577,1727.5
mulsh,FALSE,4553550,2400,715,1685,1557.5
kylin,FALSE,4553050,2464,443,2021,1453.5
woven,TRUE,4552851,2622,859,1763,1740.5
musth,FALSE,4552513,2419,651,1768,1535
sloot,FALSE,4552316,2606,1196,1410,1901
auxin,FALSE,4552248,2600,627,1973,1613.5
godly,TRUE,4552248,2408,995,1413,1701.5
mothy,FALSE,4551757,2434,889,1545,1661.5
fendy,FALSE,4551560,2600,950,1650,1775
build,TRUE,4551466,2389,905,1484,1647
foamy,TRUE,4551336,2504,1154,1350,1829
wives,FALSE,4551293,2664,688,1976,1676
ollas,FALSE,4551200.5,2848,553,2295,1700.5
spewy,FALSE,4551181,2631,993,1638,1812
wooer,TRUE,4550979,2760,1136,1624,1948
brogh,FALSE,4550724,2456,899,1557,1677.5
mozes,FALSE,4550445,2680,751,1929,1715.5
palea,FALSE,4550409,2959,940,2019,1949.5
nexus,FALSE,4550363,2718,409,2309,1563.5
mirza,FALSE,4549771,2726,556,2170,1641
updos,FALSE,4549708,2464,337,2127,1400.5
slash,TRUE,4548721.5,2554,1184,1370,1869
bawns,FALSE,4548318,2538,721,1817,1629.5
grego,FALSE,4548080.5,2866,693,2173,1779.5
lownd,FALSE,4547442,2435,693,1742,1564
rebar,TRUE,4547096,3069,779,2290,1924
doums,FALSE,4547081,2416,659,1757,1537.5
knive,FALSE,4546983,2604,843,1761,1723.5
tanas,FALSE,4546821,2744,791,1953,1767.5
nooit,FALSE,4546665,2537,971,1566,1754
redux,FALSE,4546587,2757,512,2245,1634.5
dukas,FALSE,4546367,2556,508,2048,1532
odder,TRUE,4546089.5,2936,666,2270,1801
rupee,TRUE,4545929,2696,1091,1605,1893.5
fluke,TRUE,4545744,2570,981,1589,1775.5
grouf,FALSE,4545711,2474,734,1740,1604
warre,FALSE,4545443,2996,1126,1870,2061
goose,TRUE,4544948,2647,1233,1414,1940
sylph,FALSE,4544932,2408,690,1718,1549
etage,FALSE,4544838,2932,956,1976,1944
genre,TRUE,4543815,2743,1072,1671,1907.5
mangy,TRUE,4543638,2474,990,1484,1732
serry,FALSE,4543538,2928,1287,1641,2107.5
yente,FALSE,4543374,2690,950,1740,1820
pugil,FALSE,4543291,2398,709,1689,1553.5
ouphs,FALSE,4541738,2473,349,2124,1411
trout,TRUE,4541654,2634,995,1639,1814.5
bitch,FALSE,4541608,2408,777,1631,1592.5
yonks,FALSE,4541412,2460,515,1945,1487.5
carta,FALSE,4541203,2861,868,1993,1864.5
aggie,FALSE,4541181.5,2912,802,2110,1857
moose,TRUE,4540676,2645,1225,1420,1935
wilds,FALSE,4540138,2477,502,1975,1489.5
nimps,FALSE,4540112,2459,386,2073,1422.5
kapus,FALSE,4539972,2532,500,2032,1516
tacit,TRUE,4539580,2671,920,1751,1795.5
roper,FALSE,4539324,2912,972,1940,1942
quyte,FALSE,4538742,2626,801,1825,1713.5
mazey,FALSE,4538487,2715,1104,1611,1909.5
bokeh,FALSE,4538468,2577,921,1656,1749
glisk,FALSE,4538446,2415,866,1549,1640.5
jalop,FALSE,4538130,2603,624,1979,1613.5
masse,TRUE,4537772.5,2881,1086,1795,1983.5
busty,FALSE,4537742,2426,942,1484,1684
myoid,FALSE,4537617,2405,650,1755,1527.5
scuft,FALSE,4537334,2397,859,1538,1628
rider,TRUE,4537215,2910,912,1998,1911
nikab,FALSE,4537207,2575,425,2150,1500
limbs,FALSE,4536451,2478,411,2067,1444.5
bluid,FALSE,4536271,2389,815,1574,1602
gaudy,TRUE,4536212,2453,1017,1436,1735
sects,FALSE,4536122,2789,839,1950,1814
quoit,FALSE,4536102,2473,864,1609,1668.5
howbe,FALSE,4536088,2569,822,1747,1695.5
phony,TRUE,4536052,2365,1076,1289,1720.5
suets,FALSE,4535861,2798,904,1894,1851
prees,FALSE,4535837.5,2857,940,1917,1898.5
these,TRUE,4535797.5,2720,1065,1655,1892.5
wheys,FALSE,4535764,2664,443,2221,1553.5
retem,FALSE,4535640,2858,818,2040,1838
crass,TRUE,4535461.5,2812,979,1833,1895.5
plink,FALSE,4535456,2393,904,1489,1648.5
japed,FALSE,4535442,2708,818,1890,1763
dited,FALSE,4535218.5,2740,860,1880,1800
packs,FALSE,4535193,2523,593,1930,1558
janty,FALSE,4535135,2570,966,1604,1768
ctene,FALSE,4534920.5,2721,1058,1663,1889.5
ritzy,FALSE,4534822,2603,802,1801,1702.5
buoys,FALSE,4534738,2432,642,1790,1537
mirvs,FALSE,4534707,2549,554,1995,1551.5
grubs,FALSE,4534683,2479,607,1872,1543
bavin,FALSE,4534494,2522,814,1708,1668
lassi,FALSE,4534485.5,2822,654,2168,1738
casco,FALSE,4533921,2648,792,1856,1720
wordy,TRUE,4533804,2491,958,1533,1724.5
miked,FALSE,4533269,2573,757,1816,1665
soils,FALSE,4533136,2586,1109,1477,1847.5
smack,TRUE,4533083,2475,976,1499,1725.5
voids,FALSE,4532943,2457,693,1764,1575
thugs,FALSE,4532490,2421,570,1851,1495.5
dogma,TRUE,4532342,2550,589,1961,1569.5
goldy,FALSE,4532192,2408,939,1469,1673.5
twank,FALSE,4531949,2522,795,1727,1658.5
vakil,FALSE,4531798,2555,673,1882,1614
todde,FALSE,4531621,2766,996,1770,1881
jirga,FALSE,4531608,2720,525,2195,1622.5
aduki,FALSE,4531381,2585,392,2193,1488.5
dowry,TRUE,4531197,2491,932,1559,1711.5
slots,FALSE,4531067,2606,986,1620,1796
misch,FALSE,4530887,2390,680,1710,1535
berob,FALSE,4530820,2833,721,2112,1777
frows,FALSE,4530427,2529,708,1821,1618.5
mafic,FALSE,4530184,2509,625,1884,1567
sotol,FALSE,4530180,2606,1044,1562,1825
odium,FALSE,4529844,2445,451,1994,1448
whelp,TRUE,4529820,2623,622,2001,1622.5
cache,TRUE,4529787,2792,1010,1782,1901
thanx,FALSE,4529094,2542,790,1752,1666
washy,FALSE,4528777,2517,859,1658,1688
sards,FALSE,4527995,2734,938,1796,1836
moldy,TRUE,4527920,2406,931,1475,1668.5
azido,FALSE,4527905,2634,536,2098,1585
modus,FALSE,4527824,2416,579,1837,1497.5
nappe,FALSE,4527644,2861,873,1988,1867
alkyd,FALSE,4527605,2546,475,2071,1510.5
murva,FALSE,4527569,2650,566,2084,1608
walks,FALSE,4527518,2571,590,1981,1580.5
acari,FALSE,4527207,2841,651,2190,1746
torrs,FALSE,4526398,2795,779,2016,1787
zayin,FALSE,4526396,2558,624,1934,1591
lowps,FALSE,4526102,2479,479,2000,1479
bukes,FALSE,4525582,2600,725,1875,1662.5
shmek,FALSE,4525156,2553,1002,1551,1777.5
croci,FALSE,4524635,2605,872,1733,1738.5
mochi,FALSE,4524627,2445,481,1964,1463
alans,FALSE,4524560,2725,867,1858,1796
teiid,FALSE,4524098,2740,933,1807,1836.5
ejido,FALSE,4523875,2773,467,2306,1620
waved,FALSE,4523869,2678,872,1806,1775
stash,TRUE,4523304.5,2573,1060,1513,1816.5
powin,FALSE,4522884,2410,735,1675,1572.5
blush,TRUE,4522714,2369,849,1520,1609
erect,TRUE,4522570.5,3008,921,2087,1964.5
slump,TRUE,4522547,2367,856,1511,1611.5
rumbo,FALSE,4522365,2532,434,2098,1483
refix,FALSE,4522320,2784,538,2246,1661
bingo,TRUE,4522303,2437,648,1789,1542.5
theta,TRUE,4522299,3011,673,2338,1842
fugal,FALSE,4522255,2521,708,1813,1614.5
cadgy,FALSE,4521947,2444,1017,1427,1730.5
nicks,FALSE,4521794,2465,386,2079,1425.5
mound,TRUE,4520893,2348,851,1497,1599.5
boked,FALSE,4520750,2568,900,1668,1734
onkus,FALSE,4520669,2500,258,2242,1379
abase,TRUE,4520560,2850,1059,1791,1954.5
pipet,FALSE,4520441,2716,973,1743,1844.5
shoes,FALSE,4520168,2726,1108,1618,1917
flawn,FALSE,4519992,2508,799,1709,1653.5
ronin,FALSE,4519892.5,2707,811,1896,1759
ohmic,FALSE,4519886,2445,435,2010,1440
nines,FALSE,4519777,2871,732,2139,1801.5
embus,FALSE,4519638,2696,285,2411,1490.5
untax,FALSE,4519231,2620,402,2218,1511
qaids,FALSE,4519065,2573,698,1875,1635.5
eased,FALSE,4518935,2953,892,2061,1922.5
vomit,TRUE,4518223,2434,794,1640,1614
baulk,FALSE,4518169,2483,917,1566,1700
porky,FALSE,4517851,2475,1003,1472,1739
preps,FALSE,4517490,2857,672,2185,1764.5
raker,FALSE,4517434,3004,951,2053,1977.5
gonch,FALSE,4517158,2350,824,1526,1587
pulka,FALSE,4517047,2562,559,2003,1560.5
flogs,FALSE,4517039,2446,693,1753,1569.5
beaux,FALSE,4516812,2726,812,1914,1769
oleos,FALSE,4516738,2995,587,2408,1791
murex,FALSE,4516669,2685,782,1903,1733.5
perps,FALSE,4516567,2857,633,2224,1745
lanai,FALSE,4516413,2754,705,2049,1729.5
weigh,TRUE,4516349,2576,806,1770,1691
quina,FALSE,4516346,2592,721,1871,1656.5
arepa,FALSE,4515947,3148,699,2449,1923.5
guids,FALSE,4515946,2392,672,1720,1532
azury,FALSE,4515458,2655,824,1831,1739.5
zendo,FALSE,4515422,2684,511,2173,1597.5
lests,FALSE,4515387,2989,585,2404,1787
hexad,FALSE,4515250,2751,604,2147,1677.5
gecks,FALSE,4515244,2624,504,2120,1564
anion,FALSE,4515120.5,2779,756,2023,1767.5
nabks,FALSE,4515100,2546,489,2057,1517.5
terfe,FALSE,4514677,2767,1013,1754,1890
bimah,FALSE,4514443,2500,738,1762,1619
tarry,FALSE,4514440,2830,1132,1698,1981
knish,FALSE,4514326,2396,683,1713,1539.5
black,TRUE,4514300,2474,946,1528,1710
bajri,FALSE,4514298,2687,643,2044,1665
oakum,FALSE,4513732,2539,481,2058,1510
tanti,FALSE,4513539,2773,742,2031,1757.5
chavs,FALSE,4513538,2503,731,1772,1617
bunco,FALSE,4512613,2395,708,1687,1551.5
forks,FALSE,4512561,2537,669,1868,1603
dosed,FALSE,4511978.5,2717,906,1811,1811.5
lawks,FALSE,4511921,2571,509,2062,1540
objet,FALSE,4511804,2690,631,2059,1660.5
muids,FALSE,4511674,2390,664,1726,1527
nasal,TRUE,4511331,2725,740,1985,1732.5
pilum,FALSE,4511250,2396,580,1816,1488
mecks,FALSE,4510972,2622,496,2126,1559
upbye,FALSE,4510723,2543,578,1965,1560.5
mincy,FALSE,4510634,2360,964,1396,1662
sauts,FALSE,4510522,2651,1010,1641,1830.5
samfu,FALSE,4510413,2489,767,1722,1628
cryer,FALSE,4510036,2758,1024,1734,1891
fluyt,FALSE,4510027,2396,758,1638,1577
mings,FALSE,4509690,2413,560,1853,1486.5
drunk,TRUE,4509570,2416,838,1578,1627
quilt,TRUE,4509392,2448,890,1558,1669
mixes,FALSE,4509061,2656,675,1981,1665.5
tided,FALSE,4509050.5,2740,862,1878,1801
lahar,FALSE,4509002,2773,776,1997,1774.5
vangs,FALSE,4508367,2526,598,1928,1562
pukas,FALSE,4508210,2532,539,1993,1535.5
crocs,FALSE,4508141,2576,897,1679,1736.5
mochs,FALSE,4508133,2416,506,1910,1461
yoick,FALSE,4507757,2387,816,1571,1601.5
vaxes,FALSE,4507738,2769,713,2056,1741
skimo,FALSE,4507708,2438,768,1670,1603
bowed,FALSE,4507486,2560,914,1646,1737
pulmo,FALSE,4507444,2422,566,1856,1494
defog,FALSE,4507394,2606,551,2055,1578.5
scatt,FALSE,4507332,2642,1105,1537,1873.5
niece,TRUE,4506857.5,2701,992,1709,1846.5
henna,FALSE,4506522.5,2894,696,2198,1795
milko,FALSE,4506484,2468,534,1934,1501
pyrex,FALSE,4506424,2693,654,2039,1673.5
flamy,FALSE,4506407,2479,1076,1403,1777.5
neper,FALSE,4506239,2789,867,1922,1828
rolls,FALSE,4505887,2776,694,2082,1735
kilps,FALSE,4505572,2461,420,2041,1440.5
fohns,FALSE,4505502,2427,642,1785,1534.5
hajis,FALSE,4505112,2580,570,2010,1575
fenks,FALSE,4504992,2633,608,2025,1620.5
fifer,FALSE,4504938,2747,893,1854,1820
hopak,FALSE,4504639,2509,682,1827,1595.5
litai,FALSE,4504206,2871,575,2296,1723
rawer,FALSE,4504170,2996,965,2031,1980.5
laura,FALSE,4503719,2851,773,2078,1812
joust,TRUE,4503335,2442,888,1554,1665
torii,FALSE,4503140,2824,760,2064,1792
alias,FALSE,4502928,2822,807,2015,1814.5
vinew,FALSE,4502928,2596,719,1877,1657.5
dimly,TRUE,4502714,2380,900,1480,1640
honks,FALSE,4502614,2422,578,1844,1500
saics,FALSE,4502578,2622,1124,1498,1873
munga,FALSE,4502552,2514,572,1942,1543
brung,FALSE,4502485,2411,828,1583,1619.5
abohm,FALSE,4502306,2526,471,2055,1498.5
slits,FALSE,4501867,2580,1008,1572,1794
opium,TRUE,4501853,2421,492,1929,1456.5
amene,FALSE,4501646.5,2813,962,1851,1887.5
index,TRUE,4501550,2660,522,2138,1591
stuck,TRUE,4501201,2392,873,1519,1632.5
dhikr,FALSE,4501022,2435,788,1647,1611.5
burgs,FALSE,4500760,2479,634,1845,1556.5
faqir,FALSE,4500352,2629,811,1818,1720
lanas,FALSE,4499919,2725,730,1995,1727.5
hypos,FALSE,4499816,2433,318,2115,1375.5
forum,TRUE,4499626,2472,702,1770,1587
moups,FALSE,4499553,2392,637,1755,1514.5
foxie,FALSE,4499520,2620,1009,1611,1814.5
cuzes,FALSE,4499378,2614,749,1865,1681.5
coxed,FALSE,4499068,2584,925,1659,1754.5
fonds,FALSE,4499000,2418,659,1759,1538.5
agene,FALSE,4498656.5,2815,936,1879,1875.5
scene,TRUE,4498072.5,2672,1189,1483,1930.5
veale,FALSE,4498063,2762,1178,1584,1970
fouth,FALSE,4498002,2383,858,1525,1620.5
elder,TRUE,4497213,2911,878,2033,1894.5
bongs,FALSE,4497171,2408,703,1705,1555.5
stump,TRUE,4497130,2386,732,1654,1559
sauls,FALSE,4496862,2632,1033,1599,1832.5
titan,TRUE,4496834,2773,755,2018,1764
fluty,FALSE,4496727,2396,1005,1391,1700.5
boxes,FALSE,4496542,2651,818,1833,1734.5
swank,FALSE,4496529,2473,1012,1461,1742.5
qadis,FALSE,4496337,2573,596,1977,1584.5
eider,FALSE,4496236,2910,879,2031,1894.5
scuse,FALSE,4496180.5,2579,1166,1413,1872.5
rowdy,TRUE,4495957,2491,843,1648,1667
yojan,FALSE,4495774,2576,581,1995,1578.5
tocky,FALSE,4495427,2407,903,1504,1655
eyrir,FALSE,4495368,2957,628,2329,1792.5
spink,FALSE,4494788,2363,988,1375,1675.5
cozed,FALSE,4494546,2582,924,1658,1753
junta,TRUE,4494049,2610,548,2062,1579
rally,TRUE,4493929,2811,1047,1764,1929
rooty,FALSE,4493830,2594,1131,1463,1862.5
paean,FALSE,4493525,2861,916,1945,1888.5
mogul,TRUE,4493430,2376,691,1685,1533.5
riper,TRUE,4493418,2886,895,1991,1890.5
bothy,FALSE,4493332,2403,955,1448,1679
golfs,FALSE,4493089,2446,577,1869,1511.5
stede,FALSE,4492675.5,2711,1113,1598,1912
jiver,FALSE,4492410,2716,801,1915,1758.5
mokis,FALSE,4491757,2438,592,1846,1515
preen,TRUE,4491489.5,2789,1034,1755,1911.5
codex,FALSE,4491389,2584,878,1706,1731
geres,FALSE,4491365,2811,874,1937,1842.5
divos,FALSE,4491295,2457,530,1927,1493.5
umiak,FALSE,4491121,2513,613,1900,1563
glows,FALSE,4490977,2433,621,1812,1527
shies,FALSE,4490968,2700,1130,1570,1915
apart,TRUE,4490896,2759,914,1845,1836.5
hanky,FALSE,4490656,2457,931,1526,1694
razee,FALSE,4490477,2837,1162,1675,1999.5
styes,FALSE,4490206,2758,826,1932,1792
gauge,TRUE,4489713.5,2722,1084,1638,1903
gadje,FALSE,4488822,2662,920,1742,1791
wazir,FALSE,4488769,2622,768,1854,1695
voips,FALSE,4488598,2433,674,1759,1553.5
schmo,FALSE,4488230,2416,541,1875,1478.5
abear,FALSE,4488130,3069,709,2360,1889
curer,FALSE,4487646,2798,1077,1721,1937.5
retry,TRUE,4487628,2977,974,2003,1975.5
perce,FALSE,4487553,2687,1123,1564,1905
khadi,FALSE,4487529,2507,551,1956,1529
secco,FALSE,4487526,2795,874,1921,1834.5
ogham,FALSE,4487478,2559,267,2292,1413
works,FALSE,4487236,2524,616,1908,1570
meres,FALSE,4487093,2809,866,1943,1837.5
ching,FALSE,4486887,2324,831,1493,1577.5
sculk,FALSE,4486831,2373,846,1527,1609.5
aecia,FALSE,4486828,3060,661,2399,1860.5
crump,TRUE,4486698,2386,754,1632,1570
downs,FALSE,4486657,2405,634,1771,1519.5
frown,TRUE,4486079,2461,802,1659,1631.5
aural,FALSE,4486053,2851,809,2042,1830
velum,FALSE,4485706,2608,521,2087,1564.5
umped,FALSE,4485596,2527,565,1962,1546
gowls,FALSE,4485255,2433,618,1815,1525.5
dight,FALSE,4485126,2363,661,1702,1512
towze,FALSE,4484804,2625,898,1727,1761.5
gompa,FALSE,4484498,2526,569,1957,1547.5
mopus,FALSE,4484027,2392,562,1830,1477
bonze,FALSE,4483521,2581,1035,1546,1808
dhaks,FALSE,4483460,2478,653,1825,1565.5
azyme,FALSE,4483104,2715,664,2051,1689.5
bezil,FALSE,4483060,2653,740,1913,1696.5
flims,FALSE,4483021,2418,707,1711,1562.5
carrs,FALSE,4482898,2812,853,1959,1832.5
pinko,FALSE,4482854,2418,596,1822,1507
boose,FALSE,4482251,2614,1291,1323,1952.5
comps,FALSE,4482203,2383,624,1759,1503.5
kievs,FALSE,4481809,2672,481,2191,1576.5
mudge,FALSE,4481786,2481,868,1613,1674.5
toxic,TRUE,4481777,2472,629,1843,1550.5
maxed,FALSE,4481637,2670,859,1811,1764.5
gazed,FALSE,4481387,2670,866,1804,1768
spars,FALSE,4481387,2710,922,1788,1816
figos,FALSE,4481385,2445,573,1872,1509
duing,FALSE,4481298,2324,786,1538,1555
waspy,FALSE,4481279,2484,881,1603,1682.5
derro,FALSE,4480937,2936,726,2210,1831
tirrs,FALSE,4480492,2769,702,2067,1735.5
brock,FALSE,4480387,2427,949,1478,1688
toons,FALSE,4480340,2508,890,1618,1699
borer,FALSE,4480288,2833,1145,1688,1989
stool,TRUE,4479909,2606,975,1631,1790.5
pupae,FALSE,4479845,2768,973,1795,1870.5
prexy,FALSE,4479751,2693,953,1740,1823
basse,FALSE,4479347.5,2850,1152,1698,2001
sheet,TRUE,4479141.5,2720,1258,1462,1989
stoit,FALSE,4478878,2605,1098,1507,1851.5
flong,FALSE,4478662,2378,804,1574,1591
rebel,TRUE,4478644,2808,878,1930,1843
schwa,FALSE,4478621,2548,504,2044,1526
shlub,FALSE,4478298,2369,715,1654,1542
sklim,FALSE,4478248,2413,688,1725,1550.5
gifts,FALSE,4478073,2439,517,1922,1478
roary,FALSE,4478064,2836,1207,1629,2021.5
cuifs,FALSE,4478044,2377,721,1656,1549
tosas,FALSE,4477833,2867,707,2160,1787
moved,FALSE,4477703,2546,871,1675,1708.5
ratty,TRUE,4477394,2830,1023,1807,1926.5
mazed,FALSE,4477115,2668,858,1810,1763
abysm,FALSE,4476893,2509,399,2110,1454
netts,FALSE,4476637,2891,565,2326,1728
sacra,FALSE,4476283,2812,942,1870,1877
whins,FALSE,4476237,2388,711,1677,1549.5
quist,FALSE,4475627,2418,899,1519,1658.5
liana,FALSE,4475042,2754,843,1911,1798.5
yokul,FALSE,4474854,2397,535,1862,1466
biked,FALSE,4474844,2542,823,1719,1682.5
trust,TRUE,4474525,2579,1005,1574,1792
jehad,FALSE,4474520,2741,552,2189,1646.5
vulns,FALSE,4474476,2422,559,1863,1490.5
knosp,FALSE,4473936,2389,578,1811,1483.5
vinyl,TRUE,4473933,2411,543,1868,1477
bunty,FALSE,4473835,2358,1001,1357,1679.5
sided,FALSE,4473630.5,2691,1079,1612,1885
nalas,FALSE,4472523,2725,652,2073,1688.5
kempt,FALSE,4472513,2569,626,1943,1597.5
vendu,FALSE,4471644,2582,494,2088,1538
kandy,FALSE,4471496,2448,896,1552,1672
ginch,FALSE,4471252,2324,747,1577,1535.5
dauby,FALSE,4471065,2420,968,1452,1694
pouch,TRUE,4471032,2303,877,1426,1590
mopsy,FALSE,4470414,2352,979,1373,1665.5
algae,TRUE,4470271,2913,996,1917,1954.5
bhuts,FALSE,4470254,2388,657,1731,1522.5
campy,FALSE,4470245,2418,977,1441,1697.5
pwned,FALSE,4469769,2516,761,1755,1638.5
maars,FALSE,4469701,2662,906,1756,1784
jobes,FALSE,4469580,2641,710,1931,1675.5
crool,FALSE,4469477,2606,997,1609,1801.5
gamps,FALSE,4469044,2471,566,1905,1518.5
hoick,FALSE,4468959,2349,879,1470,1614
focus,TRUE,4468926,2403,589,1814,1496
plugs,FALSE,4468813,2369,620,1749,1494.5
leave,TRUE,4468791,2762,1107,1655,1934.5
romeo,FALSE,4468463,2864,821,2043,1842.5
unmew,FALSE,4468323,2555,516,2039,1535.5
seism,FALSE,4467538.5,2619,1087,1532,1853
ether,TRUE,4467095,2939,688,2251,1813.5
color,TRUE,4467052,2606,933,1673,1769.5
scats,FALSE,4466866,2642,888,1754,1765
views,FALSE,4466862,2664,483,2181,1573.5
valve,TRUE,4466744,2762,929,1833,1845.5
firks,FALSE,4466655,2511,592,1919,1551.5
twigs,FALSE,4466236,2426,571,1855,1498.5
gonif,FALSE,4466166,2377,717,1660,1547
temse,FALSE,4466059,2639,1047,1592,1843
galea,FALSE,4465942,2913,913,2000,1913
matzo,FALSE,4465245,2582,600,1982,1591
unhip,FALSE,4465175,2379,343,2036,1361
squit,FALSE,4465094,2418,947,1471,1682.5
mixen,FALSE,4464713,2588,769,1819,1678.5
zowie,FALSE,4464660,2605,890,1715,1747.5
silos,FALSE,4464466,2586,848,1738,1717
ruses,FALSE,4464437,2968,725,2243,1846.5
plums,FALSE,4463995,2367,612,1755,1489.5
klong,FALSE,4463116,2373,688,1685,1530.5
jabot,FALSE,4463112,2543,766,1777,1654.5
piums,FALSE,4463018,2366,613,1753,1489.5
bible,TRUE,4462666,2618,1018,1600,1818
bound,TRUE,4462468,2317,917,1400,1617
kagus,FALSE,4462105,2486,509,1977,1497.5
jowar,FALSE,4461988,2640,700,1940,1670
semie,FALSE,4461914,2619,1251,1368,1935
penna,FALSE,4461630.5,2861,769,2092,1815
roger,TRUE,4461457,2866,981,1885,1923.5
chere,FALSE,4461338.5,2720,1095,1625,1907.5
quake,TRUE,4461195,2653,995,1658,1824
eyass,FALSE,4461149.5,3000,609,2391,1804.5
rorts,FALSE,4460615,2795,722,2073,1758.5
silts,FALSE,4460596,2580,855,1725,1717.5
enjoy,TRUE,4460467,2723,658,2065,1690.5
cello,TRUE,4460395,2825,772,2053,1798.5
mizen,FALSE,4460191,2586,768,1818,1677
reggo,FALSE,4460131.5,2866,548,2318,1707
rills,FALSE,4459981,2750,617,2133,1683.5
vezir,FALSE,4459892,2724,666,2058,1695
urbex,FALSE,4459866,2654,683,1971,1668.5
nisei,FALSE,4459831,2871,648,2223,1759.5
taunt,TRUE,4459766,2583,1053,1530,1818
rural,TRUE,4459449,2851,773,2078,1812
rayas,FALSE,4459208,2781,637,2144,1709
antra,FALSE,4458679,2963,555,2408,1759
baghs,FALSE,4458433,2473,608,1865,1540.5
zerks,FALSE,4457945,2748,499,2249,1623.5
ponks,FALSE,4457722,2389,651,1738,1520
rhomb,FALSE,4457610,2454,572,1882,1513
cooey,FALSE,4457380,2594,1403,1191,1998.5
dutch,TRUE,4457355,2321,699,1622,1510
tumps,FALSE,4457205,2386,482,1904,1434
chibs,FALSE,4456388,2359,668,1691,1513.5
tayra,FALSE,4456053,2830,698,2132,1764
aceta,FALSE,4455941,3080,561,2519,1820.5
rukhs,FALSE,4455834,2493,367,2126,1430
noses,FALSE,4455702,2897,750,2147,1823.5
hedgy,FALSE,4455683,2522,826,1696,1674
updry,FALSE,4455496,2427,685,1742,1556
eaned,FALSE,4455028,2885,951,1934,1918
kotch,FALSE,4454902,2369,701,1668,1535
label,TRUE,4454462,2880,923,1957,1901.5
sides,FALSE,4453703,2691,997,1694,1844
donne,FALSE,4453625.5,2649,1135,1514,1892
schav,FALSE,4453174,2503,578,1925,1540.5
finds,FALSE,4453094,2392,582,1810,1487
redds,FALSE,4452895,2881,527,2354,1704
reges,FALSE,4452699,2811,768,2043,1789.5
becks,FALSE,4452547,2591,562,2029,1576.5
oasts,FALSE,4452351,2867,600,2267,1733.5
boxen,FALSE,4452194,2583,912,1671,1747.5
stilt,TRUE,4452168,2580,1124,1456,1852
parps,FALSE,4452049,2710,695,2015,1702.5
poort,FALSE,4451924,2523,1070,1453,1796.5
socas,FALSE,4451666,2648,900,1748,1774
dured,FALSE,4451660.5,2720,896,1824,1808
grees,FALSE,4451370.5,2811,913,1898,1862
bings,FALSE,4451265,2382,626,1756,1504
brick,TRUE,4451187,2401,971,1430,1686
lasts,FALSE,4450869,2842,647,2195,1744.5
budos,FALSE,4450541,2385,602,1783,1493.5
dense,TRUE,4450416,2594,1087,1507,1840.5
ceili,FALSE,4450314,2799,879,1920,1839
xylan,FALSE,4450064,2561,428,2133,1494.5
dinks,FALSE,4449973,2387,543,1844,1465
thymi,FALSE,4449598,2408,401,2007,1404.5
ticky,FALSE,4449521,2381,826,1555,1603.5
fling,TRUE,4449462,2352,826,1526,1589
swamy,FALSE,4449384,2436,1149,1287,1792.5
coypu,FALSE,4449262,2341,557,1784,1449
yarta,FALSE,4449219,2830,676,2154,1753
lemma,FALSE,4448848.5,2911,523,2388,1717
powns,FALSE,4448500,2381,665,1716,1523
flobs,FALSE,4448163,2413,641,1772,1527
frier,FALSE,4447956,2747,1199,1548,1973
graal,FALSE,4447868,2694,1008,1686,1851
wamus,FALSE,4447738,2476,566,1910,1521
unbag,FALSE,4447686,2483,381,2102,1432
cacti,TRUE,4447543,2671,708,1963,1689.5
pight,FALSE,4446969,2339,692,1647,1515.5
macks,FALSE,4446454,2475,558,1917,1516.5
bhang,FALSE,4446375,2405,847,1558,1626
ceder,FALSE,4446221,2711,1045,1666,1878
bizes,FALSE,4446114,2623,740,1883,1681.5
reird,FALSE,4445866,2910,883,2027,1896.5
safes,FALSE,4445722,2790,1049,1741,1919.5
whelm,FALSE,4444124,2575,608,1967,1591.5
neafe,FALSE,4443930,2722,1045,1677,1883.5
indow,FALSE,4443805,2434,345,2089,1389.5
herye,FALSE,4443745,2689,901,1788,1795
ruers,FALSE,4443743,2968,656,2312,1812
penie,FALSE,4443534,2599,1105,1494,1852
ritts,FALSE,4443446,2769,593,2176,1681
zloty,FALSE,4443067,2440,951,1489,1695.5
milfs,FALSE,4442911,2418,492,1926,1455
thick,TRUE,4442815,2343,824,1519,1583.5
yoghs,FALSE,4442305,2387,416,1971,1401.5
gilpy,FALSE,4441941,2358,843,1515,1600.5
films,FALSE,4441750,2418,554,1864,1486
would,TRUE,4441299,2342,807,1535,1574.5
yrivd,FALSE,4440608,2420,703,1717,1561.5
bluds,FALSE,4440544,2360,644,1716,1502
fanks,FALSE,4440474,2486,670,1816,1578
deers,FALSE,4440386.5,2881,718,2163,1799.5
jerks,FALSE,4439965,2740,516,2224,1628
axiom,TRUE,4439788,2564,595,1969,1579.5
gawsy,FALSE,4439532,2438,980,1458,1709
geste,FALSE,4439124,2641,1000,1641,1820.5
tucks,FALSE,4438887,2392,482,1910,1437
haith,FALSE,4438090,2602,917,1685,1759.5
surra,FALSE,4437934,2821,931,1890,1876
crepe,TRUE,4437898.5,2687,1116,1571,1901.5
frore,FALSE,4437720,2773,1223,1550,1998
kinds,FALSE,4437548,2387,466,1921,1426.5
yawps,FALSE,4437520,2484,422,2062,1453
atlas,FALSE,4437217,2842,529,2313,1685.5
abmho,FALSE,4437005,2526,304,2222,1415
shock,TRUE,4436595,2320,1019,1301,1669.5
oasis,FALSE,4436201,2847,619,2228,1733
yuked,FALSE,4436124,2502,640,1862,1571
gived,FALSE,4436069,2522,802,1720,1662
armor,TRUE,4435557,2717,813,1904,1765
milks,FALSE,4435446,2413,512,1901,1462.5
rerun,TRUE,4435015,2900,722,2178,1811
bundt,FALSE,4434846,2311,820,1491,1565.5
hetes,FALSE,4434708,2720,776,1944,1748
sycee,FALSE,4434367,2539,1187,1352,1863
sakes,FALSE,4433922,2785,1036,1749,1910.5
loons,FALSE,4433438,2489,829,1660,1659
wharf,TRUE,4433407,2526,712,1814,1619
boink,FALSE,4433221,2339,1013,1326,1676
eyres,FALSE,4432963,2928,612,2316,1770
sheel,FALSE,4432151.5,2701,1161,1540,1931
sours,FALSE,4432138,2585,998,1587,1791.5
popes,FALSE,4432087,2693,833,1860,1763
clomb,FALSE,4432059,2334,722,1612,1528
cushy,FALSE,4431544,2319,856,1463,1587.5
lotos,FALSE,4431428,2606,646,1960,1626
toted,FALSE,4431312,2766,975,1791,1870.5
gulps,FALSE,4431307,2369,499,1870,1434
fawns,FALSE,4431252,2478,684,1794,1581
cered,FALSE,4431194,2711,1039,1672,1875
wawes,FALSE,4430772.5,2777,767,2010,1772
champ,TRUE,4430588,2380,773,1607,1576.5
budis,FALSE,4430521,2359,628,1731,1493.5
vibey,FALSE,4430110,2536,984,1552,1760
abcee,FALSE,4430035,2680,955,1725,1817.5
grosz,FALSE,4429900,2463,801,1662,1632
denet,FALSE,4429180,2643,1063,1580,1853
expos,FALSE,4429114,2730,312,2418,1521
gipsy,TRUE,4428780,2328,910,1418,1619
beres,FALSE,4428668,2778,932,1846,1855
buhls,FALSE,4428310,2369,566,1803,1467.5
blows,FALSE,4428280,2400,679,1721,1539.5
bigha,FALSE,4427981,2502,534,1968,1518
clunk,FALSE,4427874,2305,859,1446,1582
winds,FALSE,4427769,2379,529,1850,1454
fanum,FALSE,4427539,2421,703,1718,1562
rojak,FALSE,4427321,2648,663,1985,1655.5
luxed,FALSE,4427168,2568,722,1846,1645
durgy,FALSE,4427141,2381,900,1481,1640.5
bauks,FALSE,4426947,2453,733,1720,1593
still,TRUE,4426811,2580,1027,1553,1803.5
bykes,FALSE,4426598,2560,562,1998,1561
sleys,FALSE,4426512,2739,783,1956,1761
sulky,TRUE,4426407,2342,1083,1259,1712.5
decad,FALSE,4425524.5,2783,690,2093,1736.5
assot,FALSE,4425279,2867,622,2245,1744.5
circs,FALSE,4425157,2550,751,1799,1650.5
nanos,FALSE,4424955,2750,648,2102,1699
apace,FALSE,4424612,2759,1085,1674,1922
fitch,FALSE,4424542,2348,740,1608,1544
bawty,FALSE,4424260,2454,1006,1448,1730
dooce,FALSE,4423797,2547,1210,1337,1878.5
frugs,FALSE,4423796,2419,680,1739,1549.5
jibes,FALSE,4423674,2615,633,1982,1624
trull,FALSE,4423605,2609,899,1710,1754
gurdy,FALSE,4423412,2381,897,1484,1639
budge,TRUE,4423361,2450,934,1516,1692
pases,FALSE,4423195,2929,880,2049,1904.5
ficus,TRUE,4423020,2377,512,1865,1444.5
pique,TRUE,4422978,2535,851,1684,1693
fiere,FALSE,4422936.5,2747,1091,1656,1919
ixnay,FALSE,4422935,2560,714,1846,1637
lycee,FALSE,4422885,2569,909,1660,1739
wrier,FALSE,4422631,2734,1146,1588,1940
bowls,FALSE,4422558,2400,676,1724,1538
spies,FALSE,4422043,2667,1047,1620,1857
diene,FALSE,4421843.5,2623,1096,1527,1859.5
aldea,FALSE,4421536,2983,799,2184,1891
telly,FALSE,4420899,2788,1029,1759,1908.5
fusty,FALSE,4420676,2366,905,1461,1635.5
sorus,FALSE,4420450,2585,926,1659,1755.5
forza,FALSE,4420186,2661,662,1999,1661.5
dress,TRUE,4420163.5,2881,762,2119,1821.5
ungod,FALSE,4420104,2350,437,1913,1393.5
mysid,FALSE,4419661,2350,486,1864,1418
hithe,FALSE,4419476,2749,834,1915,1791.5
fleck,TRUE,4419453,2561,779,1782,1670
advew,FALSE,4419297,2678,545,2133,1611.5
fluid,TRUE,4419205,2329,778,1551,1553.5
privy,TRUE,4418290,2396,1085,1311,1740.5
seyen,FALSE,4417990,2641,1085,1556,1863
scall,FALSE,4417227,2623,1031,1592,1827
knops,FALSE,4417011,2389,437,1952,1413
whaps,FALSE,4416911,2446,620,1826,1533
luaus,FALSE,4416743,2632,699,1933,1665.5
motet,FALSE,4416685,2694,1068,1626,1881
loord,FALSE,4416606,2528,881,1647,1704.5
raver,FALSE,4415962,2951,988,1963,1969.5
legal,TRUE,4415769,2913,716,2197,1814.5
wanks,FALSE,4415149,2473,617,1856,1545
hakim,FALSE,4414490,2435,585,1850,1510
daals,FALSE,4414339,2545,920,1625,1732.5
sicky,FALSE,4414101,2332,1043,1289,1687.5
heles,FALSE,4414024,2701,777,1924,1739
pukey,FALSE,4413806,2478,1022,1456,1750
tusky,FALSE,4413365,2361,834,1527,1597.5
tyees,FALSE,4413245.5,2758,703,2055,1730.5
arhat,FALSE,4412933,2792,833,1959,1812.5
tithe,TRUE,4412876,2749,914,1835,1831.5
mythi,FALSE,4412727,2408,280,2128,1344
gaumy,FALSE,4412499,2381,1016,1365,1698.5
pinks,FALSE,4411816,2363,574,1789,1468.5
goyim,FALSE,4411761,2335,623,1712,1479
vrows,FALSE,4411707,2471,615,1856,1543
brusk,FALSE,4411706,2381,889,1492,1635
dwarf,TRUE,4411609,2517,640,1877,1578.5
coost,FALSE,4411575,2406,1145,1261,1775.5
cocas,FALSE,4411111,2648,732,1916,1690
puzel,FALSE,4410974,2542,813,1729,1677.5
balky,FALSE,4410969,2443,1008,1435,1725.5
rimer,FALSE,4410963,2838,898,1940,1868
youks,FALSE,4410819,2367,541,1826,1454
nonce,FALSE,4410677,2727,1031,1696,1879
enurn,FALSE,4410602.5,2900,606,2294,1753
lumps,FALSE,4410303,2367,421,1946,1394
wormy,FALSE,4410091,2419,957,1462,1688
sipes,FALSE,4409906,2667,980,1687,1823.5
motza,FALSE,4409661,2582,581,2001,1581.5
petit,FALSE,4409194,2716,906,1810,1811
terek,FALSE,4409173,2762,985,1777,1873.5
belie,TRUE,4408739,2618,1109,1509,1863.5
whamo,FALSE,4408581,2453,660,1793,1556.5
deles,FALSE,4407289,2692,819,1873,1755.5
resus,FALSE,4407085,2968,545,2423,1756.5
green,TRUE,4407022.5,2743,1007,1736,1875
elide,TRUE,4406824,2721,1032,1689,1876.5
plouk,FALSE,4406786,2326,782,1544,1554
tenny,FALSE,4406410.5,2690,1076,1614,1883
avows,FALSE,4406225,2543,461,2082,1502
freet,FALSE,4405867.5,2767,1151,1616,1959
celli,FALSE,4405851,2799,725,2074,1762
pavid,FALSE,4405694,2421,771,1650,1596
flush,TRUE,4405648,2309,812,1497,1560.5
wifey,FALSE,4405625,2521,992,1529,1756.5
reeds,FALSE,4405146.5,2881,629,2252,1755
punka,FALSE,4404678,2464,586,1878,1525
slays,FALSE,4404293,2592,913,1679,1752.5
malar,FALSE,4404183,2692,898,1794,1795
hempy,FALSE,4403981,2496,786,1710,1641
shets,FALSE,4403933,2720,862,1858,1791
filch,FALSE,4403858,2329,741,1588,1535
remen,FALSE,4403763,2741,856,1885,1798.5
kaphs,FALSE,4403688,2454,446,2008,1450
fyrds,FALSE,4403605,2449,427,2022,1438
isles,FALSE,4403553,2969,516,2453,1742.5
cerge,FALSE,4403343,2641,1103,1538,1872
climb,TRUE,4402859,2308,744,1564,1526
toits,FALSE,4402726,2605,869,1736,1737
peers,FALSE,4402229.5,2857,749,2108,1803
dined,FALSE,4402165.5,2623,888,1735,1755.5
koker,FALSE,4401907,2768,841,1927,1804.5
steed,TRUE,4401631.5,2711,1056,1655,1883.5
nonas,FALSE,4401147,2750,654,2096,1702
steys,FALSE,4401095,2758,659,2099,1708.5
zarfs,FALSE,4400892,2606,541,2065,1573.5
jolty,FALSE,4400522,2432,914,1518,1673
briar,TRUE,4400486,2660,1081,1579,1870.5
sefer,FALSE,4400414,2718,1163,1555,1940.5
kranz,FALSE,4400260,2533,780,1753,1656.5
dwalm,FALSE,4400107,2419,666,1753,1542.5
paras,FALSE,4399734,2710,808,1902,1759
witch,TRUE,4399217,2335,687,1648,1511
shawm,FALSE,4398947,2398,884,1514,1641
ardri,FALSE,4398803,2763,646,2117,1704.5
auras,FALSE,4398783,2821,689,2132,1755
coala,FALSE,4398590,2678,1010,1668,1844
vlogs,FALSE,4398319,2388,600,1788,1494
limax,FALSE,4398275,2539,522,2017,1530.5
siege,TRUE,4398220.5,2621,1245,1376,1933
maror,FALSE,4397985,2717,918,1799,1817.5
myops,FALSE,4397545,2352,460,1892,1406
firie,FALSE,4397422,2747,1083,1664,1915
redye,FALSE,4397384,2680,849,1831,1764.5
flack,TRUE,4397234,2414,909,1505,1661.5
nimbs,FALSE,4396686,2380,360,2020,1370
gambo,FALSE,4396656,2447,562,1885,1504.5
kivas,FALSE,4396536,2525,470,2055,1497.5
droid,FALSE,4396488.5,2527,898,1629,1712.5
myths,FALSE,4396233,2379,305,2074,1342
soyas,FALSE,4396016,2617,873,1744,1745
cooed,FALSE,4396008,2547,1157,1390,1852
gajos,FALSE,4395773,2527,590,1937,1558.5
zonda,FALSE,4395320,2537,554,1983,1545.5
pubis,FALSE,4394696,2335,579,1756,1457
maxis,FALSE,4394219,2509,617,1892,1563
platt,FALSE,4393923,2570,1042,1528,1806
ettin,FALSE,4393826,2920,548,2372,1734
snoot,FALSE,4393284,2508,1082,1426,1795
joyed,FALSE,4393200,2543,764,1779,1653.5
vapid,TRUE,4393088,2421,681,1740,1551
swing,TRUE,4392439,2309,899,1410,1604
lucks,FALSE,4391985,2373,421,1952,1397
seely,FALSE,4391767.5,2739,1311,1428,2025
upjet,FALSE,4391751,2553,668,1885,1610.5
marms,FALSE,4391717.5,2662,678,1984,1670
elope,TRUE,4391679,2723,991,1732,1857
creed,TRUE,4391199.5,2711,1078,1633,1894.5
yarrs,FALSE,4390914,2781,661,2120,1721
tatou,FALSE,4390760,2706,697,2009,1701.5
zineb,FALSE,4390681,2555,673,1882,1614
moxas,FALSE,4390431,2535,597,1938,1566
yomps,FALSE,4390219,2352,432,1920,1392
ruana,FALSE,4389918,2753,844,1909,1798.5
ledes,FALSE,4389913,2692,759,1933,1725.5
cheer,TRUE,4389707.5,2720,1049,1671,1884.5
snash,FALSE,4389689.5,2456,1070,1386,1763
resee,FALSE,4389552,2511,1169,1342,1840
cells,FALSE,4389357,2770,750,2020,1760
cupid,FALSE,4389250,2268,718,1550,1493
hying,FALSE,4389049,2293,581,1712,1437
quits,FALSE,4388792,2418,650,1768,1534
brees,FALSE,4388673.5,2778,971,1807,1874.5
repps,FALSE,4388603,2857,491,2366,1674
rosts,FALSE,4388337,2795,639,2156,1717
blink,TRUE,4388292,2314,935,1379,1624.5
quint,FALSE,4388170,2350,910,1440,1630
jirds,FALSE,4388067,2499,490,2009,1494.5
backs,FALSE,4388029,2444,624,1820,1534
gyves,FALSE,4387823,2540,541,1999,1540.5
styte,FALSE,4387582,2758,1035,1723,1896.5
slurs,FALSE,4387209,2560,920,1640,1740
cough,TRUE,4386822,2257,857,1400,1557
hyrax,FALSE,4386780,2579,426,2153,1502.5
liege,TRUE,4386738.5,2651,967,1684,1809
degum,FALSE,4386676,2481,544,1937,1512.5
gouch,FALSE,4386565,2257,850,1407,1553.5
pipes,FALSE,4386181,2667,756,1911,1711.5
swift,TRUE,4385928,2333,964,1369,1648.5
satay,FALSE,4385514,2611,1308,1303,1959.5
pongy,FALSE,4385395,2286,1000,1286,1643
abbes,FALSE,4384374,2850,568,2282,1709
cuspy,FALSE,4384046,2286,878,1408,1582
blown,TRUE,4383932,2332,773,1559,1552.5
heame,FALSE,4383663,2642,1110,1532,1876
kerel,FALSE,4383326,2743,899,1844,1821
mirky,FALSE,4383206,2401,891,1510,1646
rewet,FALSE,4382690,2754,944,1810,1849
owing,TRUE,4382439,2364,574,1790,1469
erned,FALSE,4382330,2813,914,1899,1863.5
dying,TRUE,4382314,2284,623,1661,1453.5
mouch,FALSE,4382293,2255,842,1413,1548.5
press,TRUE,4382006.5,2857,793,2064,1825
edile,FALSE,4381940,2721,944,1777,1832.5
raird,FALSE,4381348,2763,945,1818,1854
haded,FALSE,4380674.5,2714,884,1830,1799
thees,FALSE,4380301.5,2720,824,1896,1772
tryst,TRUE,4379957,2539,869,1670,1704
deoxy,FALSE,4379779,2553,964,1589,1758.5
posse,TRUE,4379529.5,2693,1096,1597,1894.5
glums,FALSE,4379528,2321,585,1736,1453
houfs,FALSE,4379486,2334,584,1750,1459
foxes,FALSE,4379476,2591,781,1810,1686
stays,FALSE,4378876,2611,789,1822,1700
mimeo,FALSE,4378865,2674,746,1928,1710
arbor,TRUE,4378820,2686,809,1877,1747.5
imply,TRUE,4378668,2356,656,1700,1506
sixty,TRUE,4378016,2386,1083,1303,1734.5
solon,FALSE,4377878,2489,1019,1470,1754
stonn,FALSE,4377657,2508,999,1509,1753.5
dingy,TRUE,4377646,2284,892,1392,1588
bortz,FALSE,4377550,2479,758,1721,1618.5
varix,FALSE,4377190,2579,676,1903,1627.5
bilks,FALSE,4377021,2382,578,1804,1480
sowse,FALSE,4376992.5,2541,1266,1275,1903.5
gurge,FALSE,4376913.5,2650,964,1686,1807
yufts,FALSE,4376656,2366,392,1974,1379
paals,FALSE,4376182,2521,951,1570,1736
barbs,FALSE,4375850,2631,700,1931,1665.5
waulk,FALSE,4375778,2410,827,1583,1618.5
septs,FALSE,4375732,2687,841,1846,1764
nests,FALSE,4375622,2891,534,2357,1712.5
jarks,FALSE,4375447,2593,578,2015,1585.5
sewer,TRUE,4375350,2705,1164,1541,1934.5
gopak,FALSE,4375280,2430,728,1702,1579
afear,FALSE,4375246,3009,701,2308,1855
sleep,TRUE,4375176.5,2668,1118,1550,1893
ligge,FALSE,4375011.5,2651,857,1794,1754
tenge,FALSE,4374756,2573,1030,1543,1801.5
egret,TRUE,4374651,2860,818,2042,1839
conky,FALSE,4374456,2290,1035,1255,1662.5
sleds,FALSE,4374223,2692,849,1843,1770.5
viver,FALSE,4373321,2689,824,1865,1756.5
gonks,FALSE,4373255,2343,624,1719,1483.5
anoas,FALSE,4373096,2750,671,2079,1710.5
murks,FALSE,4372572,2412,547,1865,1479.5
dryer,TRUE,4372519,2680,937,1743,1808.5
maaed,FALSE,4372371,2633,1154,1479,1893.5
snots,FALSE,4372035,2508,872,1636,1690
yocks,FALSE,4371901,2358,432,1926,1395
forby,FALSE,4371358,2401,966,1435,1683.5
wongi,FALSE,4371274,2364,588,1776,1476
synes,FALSE,4371249,2641,882,1759,1761.5
reive,FALSE,4370915,2689,1083,1606,1886
gypos,FALSE,4370457,2354,364,1990,1359
alarm,TRUE,4370160,2692,843,1849,1767.5
furze,FALSE,4370044,2592,929,1663,1760.5
gazon,FALSE,4369641,2467,692,1775,1579.5
peles,FALSE,4369132,2668,850,1818,1759
emoji,FALSE,4369058,2701,367,2334,1534
globy,FALSE,4368986,2305,948,1357,1626.5
monks,FALSE,4368983,2341,616,1725,1478.5
steme,FALSE,4368962.5,2639,1112,1527,1875.5
yukos,FALSE,4368726,2367,372,1995,1369.5
fouds,FALSE,4368407,2325,685,1640,1505
tolls,FALSE,4368339,2606,738,1868,1672
hoxed,FALSE,4368286,2515,796,1719,1655.5
snuck,TRUE,4367586,2275,883,1392,1579
tupik,FALSE,4367229,2319,664,1655,1491.5
dungs,FALSE,4367012,2295,548,1747,1421.5
testy,TRUE,4366530,2758,974,1784,1866
tauts,FALSE,4366452,2651,793,1858,1722
gleet,FALSE,4366417.5,2671,1064,1607,1867.5
duxes,FALSE,4366383,2538,663,1875,1600.5
calyx,FALSE,4365364,2459,625,1834,1542
cilia,FALSE,4365288,2652,734,1918,1693
douks,FALSE,4365286,2320,646,1674,1483
chewy,FALSE,4365044,2494,908,1586,1701
dhobi,FALSE,4364565,2336,534,1802,1435
cundy,FALSE,4364484,2242,956,1286,1599
serve,TRUE,4364353,2660,1241,1419,1950.5
kerne,FALSE,4364095,2645,1031,1614,1838
noint,FALSE,4364091.5,2537,1017,1520,1777
gowns,FALSE,4364033,2335,638,1697,1486.5
julep,FALSE,4363378,2534,692,1842,1613
frock,TRUE,4363321,2367,912,1455,1639.5
speel,FALSE,4363226.5,2668,1078,1590,1873
grece,FALSE,4363091.5,2641,1135,1506,1888
grovy,FALSE,4363023,2376,1036,1340,1706
stedd,FALSE,4362898.5,2711,807,1904,1759
hoors,FALSE,4362556,2507,780,1727,1643.5
tolts,FALSE,4362432,2606,715,1891,1660.5
jaxie,FALSE,4362406,2676,918,1758,1797
embog,FALSE,4361681,2594,340,2254,1467
saids,FALSE,4361589,2544,1041,1503,1792.5
deids,FALSE,4361125,2691,724,1967,1707.5
refel,FALSE,4360764,2748,846,1902,1797
ogmic,FALSE,4360258,2366,303,2063,1334.5
appro,FALSE,4360165.5,2765,470,2295,1617.5
wrung,TRUE,4360094,2338,738,1600,1538
deice,FALSE,4359304,2521,1195,1326,1858
ramal,FALSE,4359283,2692,789,1903,1740.5
genie,TRUE,4359067,2553,1078,1475,1815.5
vagus,FALSE,4358931,2433,532,1901,1482.5
sados,FALSE,4358881,2570,913,1657,1741.5
canon,TRUE,4358864.5,2580,903,1677,1741.5
flisk,FALSE,4358683,2322,887,1435,1604.5
creme,TRUE,4358530.5,2639,1134,1505,1886.5
might,TRUE,4358230,2291,657,1634,1474
tymps,FALSE,4358221,2346,319,2027,1332.5
fiked,FALSE,4357778,2482,786,1696,1634
quoin,FALSE,4357494,2356,741,1615,1548.5
pudic,FALSE,4357330,2268,592,1676,1430
imshy,FALSE,4357100,2359,544,1815,1451.5
manky,FALSE,4357025,2376,969,1407,1672.5
ticca,FALSE,4356938,2671,623,2048,1647
snyes,FALSE,4356591,2641,836,1805,1738.5
tally,TRUE,4356381,2641,1091,1550,1866
bipod,FALSE,4356006,2303,683,1620,1493
pepos,FALSE,4355877,2693,610,2083,1651.5
krubi,FALSE,4355868,2410,487,1923,1448.5
doors,FALSE,4355821,2498,822,1676,1660
combi,FALSE,4355271,2333,573,1760,1453
repro,FALSE,4354652,2912,615,2297,1763.5
shell,TRUE,4354294,2701,1005,1696,1853
ratha,FALSE,4354181,2792,612,2180,1702
boxla,FALSE,4353738,2534,690,1844,1612
momes,FALSE,4353733,2645,801,1844,1723
soaps,FALSE,4352588,2546,1038,1508,1792
puked,FALSE,4352434,2431,776,1655,1603.5
fleer,FALSE,4352282.5,2748,1044,1704,1896
whity,FALSE,4352179,2304,996,1308,1650
coses,FALSE,4351887,2795,911,1884,1853
sturt,FALSE,4351170,2579,1013,1566,1796
vocab,FALSE,4349936,2446,552,1894,1499
steep,TRUE,4349759.5,2687,994,1693,1840.5
bodhi,FALSE,4349609,2336,566,1770,1451
rabat,FALSE,4349536,2680,882,1798,1781
pyxie,FALSE,4349286,2503,759,1744,1631
dowly,FALSE,4348939,2302,942,1360,1622
steds,FALSE,4348806,2711,725,1986,1718
chows,FALSE,4348639,2312,647,1665,1479.5
verse,TRUE,4348378,2660,1043,1617,1851.5
tutor,TRUE,4348322,2634,790,1844,1712
voxel,FALSE,4348026,2563,808,1755,1685.5
bogus,FALSE,4347735,2315,637,1678,1476
revie,FALSE,4346993,2689,978,1711,1833.5
turnt,FALSE,4346966,2511,933,1578,1722
smarm,FALSE,4346897,2662,905,1757,1783.5
orlon,FALSE,4346764,2708,682,2026,1695
kyang,FALSE,4346707,2378,573,1805,1475.5
snool,FALSE,4346294,2489,985,1504,1737
jumar,FALSE,4346189,2528,642,1886,1585
found,TRUE,4345402,2257,880,1377,1568.5
pikul,FALSE,4345258,2300,594,1706,1447
showy,TRUE,4344761,2281,1143,1138,1712
wifed,FALSE,4344253,2474,746,1728,1610
mauby,FALSE,4344169,2348,964,1384,1656
canal,TRUE,4343609,2555,960,1595,1757.5
peage,FALSE,4343589,2611,1191,1420,1901
pulik,FALSE,4343343,2300,711,1589,1505.5
poeps,FALSE,4343206,2693,684,2009,1688.5
jotun,FALSE,4343046,2374,622,1752,1498
snits,FALSE,4342835,2482,894,1588,1688
wrawl,FALSE,4342821,2588,838,1750,1713
plotz,FALSE,4342579,2369,730,1639,1549.5
local,TRUE,4342526,2678,742,1936,1710
mamey,FALSE,4341775,2680,1154,1526,1917
jamon,FALSE,4341241,2457,647,1810,1552
blimy,FALSE,4341147,2277,1072,1205,1674.5
reorg,FALSE,4340799,2866,784,2082,1825
pecky,FALSE,4340771,2469,859,1610,1664
swack,FALSE,4340211,2371,982,1389,1676.5
bibes,FALSE,4340132,2588,786,1802,1687
jokes,FALSE,4339900,2576,665,1911,1620.5
woose,FALSE,4339860,2541,1201,1340,1871
strut,TRUE,4339482,2579,941,1638,1760
creep,TRUE,4339327.5,2687,1016,1671,1851.5
datal,FALSE,4339145,2594,845,1749,1719.5
speos,FALSE,4338878,2693,772,1921,1732.5
sadis,FALSE,4338861,2544,939,1605,1741.5
crumb,TRUE,4338816,2307,709,1598,1508
combs,FALSE,4338777,2304,598,1706,1451
unbid,FALSE,4338759,2291,453,1838,1372
gases,FALSE,4338728,2883,853,2030,1868
chiks,FALSE,4338651,2294,699,1595,1496.5
spick,FALSE,4338470,2261,958,1303,1609.5
kemps,FALSE,4338253,2520,409,2111,1464.5
ender,FALSE,4338181,2813,764,2049,1788.5
burfi,FALSE,4338106,2415,568,1847,1491.5
croon,FALSE,4337859,2508,971,1537,1739.5
whams,FALSE,4337543,2398,638,1760,1518
swamp,TRUE,4336140,2365,841,1524,1603
apses,FALSE,4335980,2929,636,2293,1782.5
rumpy,FALSE,4335813,2355,766,1589,1560.5
fecks,FALSE,4335481,2531,525,2006,1528
idled,FALSE,4335240,2721,602,2119,1661.5
sodas,FALSE,4335073,2570,919,1651,1744.5
basij,FALSE,4335072,2468,715,1753,1591.5
vauch,FALSE,4335064,2342,803,1539,1572.5
spets,FALSE,4335008,2687,779,1908,1733
poufs,FALSE,4334594,2301,657,1644,1479
mases,FALSE,4334456,2881,845,2036,1863
pryer,FALSE,4334362,2656,968,1688,1812
sixth,TRUE,4334362,2348,858,1490,1603
bemud,FALSE,4334335,2448,676,1772,1562
gadge,FALSE,4334202.5,2635,994,1641,1814.5
poori,FALSE,4334158,2503,828,1675,1665.5
fixes,FALSE,4333570,2565,704,1861,1634.5
hocks,FALSE,4333103,2320,495,1825,1407.5
tacan,FALSE,4332962,2574,802,1772,1688
corso,FALSE,4332853,2576,869,1707,1722.5
dampy,FALSE,4332728,2340,890,1450,1615
saves,FALSE,4332450,2732,1073,1659,1902.5
shall,TRUE,4332075,2554,1135,1419,1844.5
slojd,FALSE,4331995,2336,931,1405,1633.5
scans,FALSE,4331984,2525,931,1594,1728
drool,TRUE,4331960,2528,910,1618,1719
gnows,FALSE,4331945,2335,507,1828,1421
iliac,TRUE,4331044,2652,695,1957,1673.5
stint,TRUE,4330946,2482,1144,1338,1813
tweer,FALSE,4330679.5,2754,900,1854,1827
skody,FALSE,4330643,2280,1053,1227,1666.5
reccy,FALSE,4330516,2758,919,1839,1838.5
mutch,FALSE,4330459,2249,695,1554,1472
seeld,FALSE,4330395.5,2692,1065,1627,1878.5
latah,FALSE,4330378,2603,805,1798,1704
betel,TRUE,4329922,2638,1000,1638,1819
hello,TRUE,4329613,2756,643,2113,1699.5
dolor,FALSE,4329535,2528,846,1682,1687
pungs,FALSE,4328855,2271,579,1692,1425
kanae,FALSE,4328663,2717,1050,1667,1883.5
debug,TRUE,4328652,2450,533,1917,1491.5
avale,FALSE,4328237,2762,1049,1713,1905.5
aweel,FALSE,4328005.5,2807,836,1971,1821.5
jakey,FALSE,4327942,2611,1018,1593,1814.5
naunt,FALSE,4327817.5,2583,941,1642,1762
tacts,FALSE,4327534,2642,684,1958,1663
ginge,FALSE,4327418.5,2553,956,1597,1754.5
ginks,FALSE,4327349,2317,547,1770,1432
pouks,FALSE,4327129,2296,677,1619,1486.5
recur,TRUE,4326882,2798,697,2101,1747.5
hooey,FALSE,4326598,2525,1274,1251,1899.5
docks,FALSE,4326368,2311,537,1774,1424
flexo,FALSE,4326286,2621,575,2046,1598
acais,FALSE,4325965,2622,682,1940,1652
gambs,FALSE,4325618,2392,540,1852,1466
chufa,FALSE,4325296,2400,606,1794,1503
lauan,FALSE,4324978,2564,850,1714,1707
quino,FALSE,4324948,2356,715,1641,1535.5
calls,FALSE,4324839,2623,812,1811,1717.5
coots,FALSE,4324740,2406,896,1510,1651
quoad,FALSE,4324724,2438,734,1704,1586
motte,FALSE,4324683,2694,1060,1634,1877
flaky,TRUE,4324612,2383,1063,1320,1723
raggs,FALSE,4324575.5,2664,588,2076,1626
prior,TRUE,4324476,2503,1019,1484,1761
alloy,TRUE,4324450.5,2647,950,1697,1798.5
dunch,FALSE,4324302,2204,727,1477,1465.5
antas,FALSE,4324286,2744,538,2206,1641
offer,TRUE,4323854,2773,604,2169,1688.5
cotta,FALSE,4323758,2697,791,1906,1744
mense,FALSE,4323520,2522,1083,1439,1802.5
poxed,FALSE,4323394,2482,869,1613,1675.5
minks,FALSE,4323077,2315,539,1776,1427
tills,FALSE,4322433,2580,661,1919,1620.5
nided,FALSE,4322383.5,2623,750,1873,1686.5
befog,FALSE,4322073,2503,613,1890,1558
bigly,FALSE,4321981,2279,968,1311,1623.5
quash,TRUE,4321099,2392,826,1566,1609
pepsi,FALSE,4321076,2667,624,2043,1645.5
sally,TRUE,4320961,2592,1308,1284,1950
sooty,TRUE,4320862,2375,1392,983,1883.5
roods,FALSE,4320581,2498,733,1765,1615.5
wound,TRUE,4320077,2244,827,1417,1535.5
ohone,FALSE,4319888,2658,1035,1623,1846.5
pshaw,FALSE,4319829,2446,347,2099,1396.5
wheft,FALSE,4319692,2503,692,1811,1597.5
akene,FALSE,4319446.5,2717,934,1783,1825.5
hawms,FALSE,4319354,2398,503,1895,1450.5
cimex,FALSE,4319231,2486,787,1699,1636.5
mesel,FALSE,4319201,2620,903,1717,1761.5
sasse,FALSE,4319052.5,2583,1345,1238,1964
gaitt,FALSE,4319041,2523,1077,1446,1800
kings,FALSE,4318653,2317,473,1844,1395
rarer,TRUE,4318647,2802,1102,1700,1952
exing,FALSE,4318347,2590,575,2015,1582.5
bylaw,TRUE,4317989,2435,488,1947,1461.5
kudos,FALSE,4317929,2320,449,1871,1384.5
firer,FALSE,4317316,2747,1031,1716,1889
eloge,FALSE,4317129,2677,1017,1660,1847
wacko,FALSE,4316676,2426,556,1870,1491
scowp,FALSE,4316669,2279,731,1548,1505
tilts,FALSE,4316526,2580,638,1942,1609
class,TRUE,4316248.5,2623,913,1710,1768
hexyl,FALSE,4315888,2537,482,2055,1509.5
thunk,FALSE,4315877,2255,753,1502,1504
dwams,FALSE,4315745,2389,566,1823,1477.5
podex,FALSE,4315715,2482,822,1660,1652
duply,FALSE,4315595,2238,881,1357,1559.5
heder,FALSE,4315439,2642,916,1726,1779
cajun,FALSE,4314944,2391,717,1674,1554
doona,FALSE,4314777,2502,880,1622,1691
braai,FALSE,4314395,2660,921,1739,1790.5
tatus,FALSE,4314274,2651,682,1969,1666.5
burks,FALSE,4314147,2381,613,1768,1497
gulch,TRUE,4314047,2232,704,1528,1468
baaed,FALSE,4313946,2602,1220,1382,1911
gawds,FALSE,4313708,2391,550,1841,1470.5
meers,FALSE,4313490.5,2809,714,2095,1761.5
queys,FALSE,4313437,2577,425,2152,1501
spats,FALSE,4312789,2540,909,1631,1724.5
betta,FALSE,4312420,2899,729,2170,1814
purer,TRUE,4311972,2696,1021,1675,1858.5
tazze,FALSE,4311648,2667,908,1759,1787.5
feres,FALSE,4311602,2718,895,1823,1806.5
doorn,FALSE,4311473,2430,916,1514,1673
flows,FALSE,4311214,2340,642,1698,1491
mungo,FALSE,4311154,2278,566,1712,1422
cools,FALSE,4311080,2387,919,1468,1653
maras,FALSE,4310995,2662,773,1889,1717.5
temes,FALSE,4310563,2639,806,1833,1722.5
bonks,FALSE,4310558,2310,682,1628,1496
braxy,FALSE,4310368,2467,1114,1353,1790.5
canns,FALSE,4310350.5,2525,859,1666,1692
kirby,FALSE,4309906,2370,773,1597,1571.5
woxen,FALSE,4309803,2510,822,1688,1666
mulch,TRUE,4309775,2230,696,1534,1463
fykes,FALSE,4309532,2500,525,1975,1512.5
zinke,FALSE,4309244,2490,823,1667,1656.5
moola,FALSE,4309103,2528,856,1672,1692
emote,FALSE,4309096,2694,917,1777,1805.5
pipal,FALSE,4308915,2550,721,1829,1635.5
wings,FALSE,4308874,2309,536,1773,1422.5
aldol,FALSE,4308861.5,2600,705,1895,1652.5
wrick,FALSE,4308796,2328,881,1447,1604.5
chink,FALSE,4308651,2226,903,1323,1564.5
droll,TRUE,4308062,2528,940,1588,1734
mimes,FALSE,4307827,2619,724,1895,1671.5
unify,TRUE,4307805,2278,785,1493,1531.5
beset,TRUE,4307766,2608,1066,1542,1837
slaps,FALSE,4307659,2521,960,1561,1740.5
parrs,FALSE,4307224,2710,797,1913,1753.5
genet,FALSE,4306556,2573,1067,1506,1820
fudge,TRUE,4306295,2390,897,1493,1643.5
faxed,FALSE,4306146,2579,888,1691,1733.5
vitex,FALSE,4306016,2556,682,1874,1619
teeny,FALSE,4305965.5,2690,1114,1576,1902
skeer,FALSE,4305931.5,2713,1083,1630,1898
folks,FALSE,4305861,2348,618,1730,1483
fowls,FALSE,4305492,2340,639,1701,1489.5
flawy,FALSE,4305400,2375,1033,1342,1704
withy,FALSE,4305035,2304,788,1516,1546
bilgy,FALSE,4304694,2279,927,1352,1603
urger,FALSE,4304611,2650,897,1753,1773.5
steps,FALSE,4304461,2687,706,1981,1696.5
axing,FALSE,4304337,2443,644,1799,1543.5
whang,FALSE,4303984,2332,757,1575,1544.5
venae,FALSE,4303778,2664,1011,1653,1837.5
wizes,FALSE,4303723,2550,650,1900,1600
troth,FALSE,4303616,2556,938,1618,1747
anlas,FALSE,4303602,2725,539,2186,1632
salad,TRUE,4303458,2545,1063,1482,1804
elect,TRUE,4303357.5,2819,855,1964,1837
gibus,FALSE,4303201,2289,492,1797,1390.5
ackee,FALSE,4302677,2615,935,1680,1775
junto,TRUE,4302651,2374,542,1832,1458
tenty,FALSE,4302623,2690,1033,1657,1861.5
brers,FALSE,4302357,2778,805,1973,1791.5
tasty,TRUE,4302012,2611,1036,1575,1823.5
syens,FALSE,4301995,2641,784,1857,1712.5
kydst,FALSE,4301910,2274,542,1732,1408
segos,FALSE,4301735,2647,843,1804,1745
fazed,FALSE,4301624,2577,887,1690,1732
rerig,FALSE,4301386,2840,709,2131,1774.5
metes,FALSE,4301077,2639,814,1825,1726.5
shist,FALSE,4300770.5,2311,1200,1111,1755.5
bunds,FALSE,4300586,2262,603,1659,1432.5
sheen,TRUE,4300533.5,2603,1135,1468,1869
troop,TRUE,4300505,2523,848,1675,1685.5
etens,FALSE,4299998.5,2891,544,2347,1717.5
mesne,FALSE,4299970,2522,1035,1487,1778.5
rusas,FALSE,4299901,2821,570,2251,1695.5
crura,FALSE,4299830,2651,846,1805,1748.5
bight,FALSE,4299805,2260,723,1537,1491.5
dados,FALSE,4299734,2570,658,1912,1614
hulks,FALSE,4299503,2304,458,1846,1381
zinco,FALSE,4299005,2353,554,1799,1453.5
dimps,FALSE,4298780,2279,460,1819,1369.5
gybed,FALSE,4298663,2410,631,1779,1520.5
ensue,TRUE,4298473,2681,745,1936,1713
gaged,FALSE,4298049,2635,922,1713,1778.5
lassu,FALSE,4297855.5,2632,644,1988,1638
yells,FALSE,4297373,2739,558,2181,1648.5
cloot,FALSE,4297254,2436,1028,1408,1732
epopt,FALSE,4296153.5,2742,680,2062,1711
slosh,TRUE,4295595.5,2318,1121,1197,1719.5
mille,FALSE,4295312,2649,1007,1642,1828
sweer,FALSE,4295259.5,2705,1117,1588,1911
winze,FALSE,4295224,2482,868,1614,1675
gosse,FALSE,4295062.5,2647,1069,1578,1858
denes,FALSE,4294920,2594,846,1748,1720
aahed,FALSE,4294718,2714,890,1824,1802
revet,FALSE,4294482,2709,967,1742,1838
serfs,FALSE,4294470,2718,842,1876,1780
emmas,FALSE,4294413.5,2881,370,2511,1625.5
zigan,FALSE,4294095,2441,565,1876,1503
stept,FALSE,4293839,2687,923,1764,1805
totem,TRUE,4293744,2694,899,1795,1796.5
jupes,FALSE,4293292,2504,618,1886,1561
hejab,FALSE,4292758,2638,488,2150,1563
wirer,FALSE,4291991,2734,978,1756,1856
lefte,FALSE,4291965,2578,918,1660,1748
cohoe,FALSE,4291764,2556,1042,1514,1799
finch,TRUE,4291489,2231,768,1463,1499.5
scala,FALSE,4291396,2623,939,1684,1781
quays,FALSE,4291218,2430,555,1875,1492.5
linux,FALSE,4290835,2339,519,1820,1429
jambe,FALSE,4289533,2557,833,1724,1695
sidas,FALSE,4289167,2544,842,1702,1693
upper,TRUE,4288753.5,2696,682,2014,1689
users,FALSE,4288470,2968,414,2554,1691
pocks,FALSE,4288211,2287,568,1719,1427.5
jonty,FALSE,4288153,2334,941,1393,1637.5
aroha,FALSE,4288100,2798,744,2054,1771
upsee,FALSE,4288036,2477,916,1561,1696.5
wolfs,FALSE,4288001,2340,545,1795,1442.5
pudsy,FALSE,4287470,2208,938,1270,1573
hicks,FALSE,4287197,2294,418,1876,1356
sever,TRUE,4287142,2660,1187,1473,1923.5
serks,FALSE,4287005,2713,862,1851,1787.5
loyal,TRUE,4286876,2647,715,1932,1681
ashes,FALSE,4286683,2962,520,2442,1741
saddo,FALSE,4286447,2570,872,1698,1721
punch,TRUE,4286145,2180,758,1422,1469
usual,TRUE,4285665,2632,533,2099,1582.5
qibla,FALSE,4285386,2500,508,1992,1504
spell,TRUE,4285369,2668,922,1746,1795
mucid,FALSE,4285227,2220,625,1595,1422.5
wauks,FALSE,4284556,2380,643,1737,1511.5
coach,TRUE,4284389,2409,1075,1334,1742
squeg,FALSE,4283985,2460,895,1565,1677.5
cycle,TRUE,4283717,2569,863,1706,1716
friar,TRUE,4283420,2600,1044,1556,1822
showd,FALSE,4283389,2234,897,1337,1565.5
lumbi,FALSE,4283371,2317,370,1947,1343.5
poupe,FALSE,4283179,2532,1060,1472,1796
cowps,FALSE,4282522,2279,589,1690,1434
radii,TRUE,4282497,2763,653,2110,1708
cross,TRUE,4282335.5,2576,916,1660,1746
capiz,FALSE,4282250,2385,722,1663,1553.5
staps,FALSE,4282242,2540,836,1704,1688
dwang,FALSE,4282186,2323,685,1638,1504
awful,TRUE,4282146,2415,448,1967,1431.5
sords,FALSE,4281013,2498,913,1585,1705.5
yetts,FALSE,4280838,2758,534,2224,1646
waxed,FALSE,4280821,2566,835,1731,1700.5
targa,FALSE,4280601,2713,756,1957,1734.5
dicks,FALSE,4280462,2285,460,1825,1372.5
smock,TRUE,4279957,2239,913,1326,1576
sopor,FALSE,4279844,2474,1047,1427,1760.5
alays,FALSE,4279542,2592,688,1904,1640
umbos,FALSE,4279006,2313,296,2017,1304.5
fondu,FALSE,4278864,2257,624,1633,1440.5
drill,TRUE,4278862,2502,962,1540,1732
hymns,FALSE,4278609,2262,371,1891,1316.5
udder,TRUE,4278209.5,2720,658,2062,1689
ossia,FALSE,4278071,2847,359,2488,1603
memos,FALSE,4277523,2645,578,2067,1611.5
limby,FALSE,4277511,2277,739,1538,1508
sooth,TRUE,4277208,2337,1167,1170,1752
rieve,FALSE,4277136.5,2689,954,1735,1821.5
semis,FALSE,4277127,2619,863,1756,1741
bewig,FALSE,4276989,2464,640,1824,1552
salps,FALSE,4276950,2521,868,1653,1694.5
chevy,FALSE,4276817,2449,929,1520,1689
ragas,FALSE,4276601,2664,675,1989,1669.5
roops,FALSE,4276236,2474,714,1760,1594
plaps,FALSE,4276058,2521,736,1785,1628.5
bases,FALSE,4276031,2850,911,1939,1880.5
prana,FALSE,4275978,2642,962,1680,1802
yakow,FALSE,4275973,2395,471,1924,1433
humic,FALSE,4275970,2229,505,1724,1367
leggo,FALSE,4275681.5,2677,531,2146,1604
lever,TRUE,4275660,2690,909,1781,1799.5
waltz,TRUE,4275441,2453,642,1811,1547.5
weise,FALSE,4275367,2515,1186,1329,1850.5
grass,TRUE,4275320.5,2664,896,1768,1780
jehus,FALSE,4275036,2537,389,2148,1463
fumed,FALSE,4274621,2388,819,1569,1603.5
obese,TRUE,4273625.5,2614,829,1785,1721.5
zaidy,FALSE,4273589,2378,1006,1372,1692
knobs,FALSE,4273585,2310,411,1899,1360.5
sends,FALSE,4273444,2594,852,1742,1723
reffo,FALSE,4273162,2773,465,2308,1619
exurb,FALSE,4273084,2654,414,2240,1534
pized,FALSE,4272966,2454,791,1663,1622.5
spitz,FALSE,4272711,2313,836,1477,1574.5
butch,TRUE,4272034,2218,761,1457,1489.5
boygs,FALSE,4272010,2275,593,1682,1434
paolo,FALSE,4271985,2576,910,1666,1743
deets,FALSE,4271788.5,2711,705,2006,1708
flexi,FALSE,4271742,2595,528,2067,1561.5
vowed,FALSE,4271700,2442,784,1658,1613
frees,FALSE,4271607.5,2718,934,1784,1826
frowy,FALSE,4271487,2328,1036,1292,1682
width,TRUE,4271260,2257,638,1619,1447.5
nolos,FALSE,4270979,2489,596,1893,1542.5
pirai,FALSE,4270968,2739,681,2058,1710
curvy,TRUE,4270606,2308,957,1351,1632.5
roker,FALSE,4270452,2768,926,1842,1847
proll,FALSE,4269905,2504,971,1533,1737.5
equid,FALSE,4269896,2559,518,2041,1538.5
gawps,FALSE,4269363,2367,531,1836,1449
essay,TRUE,4269263,3000,695,2305,1847.5
aggro,FALSE,4269193.5,2719,430,2289,1574.5
whelk,FALSE,4269189,2479,679,1800,1579
resew,FALSE,4269159,2705,762,1943,1733.5
queyn,FALSE,4269089,2509,519,1990,1514
whipt,FALSE,4268845,2233,796,1437,1514.5
damme,FALSE,4268571.5,2633,968,1665,1800.5
fritz,TRUE,4268362,2393,812,1581,1602.5
cawks,FALSE,4268341,2371,619,1752,1495
teaze,FALSE,4268321,2667,1142,1525,1904.5
bonne,FALSE,4268304.5,2546,1197,1349,1871.5
leges,FALSE,4268249,2622,751,1871,1686.5
petto,FALSE,4268186,2742,692,2050,1717
sneed,FALSE,4268016.5,2594,1066,1528,1830
shirs,FALSE,4267986,2481,964,1517,1722.5
ruder,TRUE,4267641,2720,896,1824,1808
clump,TRUE,4267485,2197,688,1509,1442.5
flown,TRUE,4266866,2272,736,1536,1504
slish,FALSE,4266395.5,2292,1143,1149,1717.5
shoji,FALSE,4266322,2344,767,1577,1555.5
botte,FALSE,4266258,2663,1126,1537,1894.5
winch,TRUE,4266164,2218,715,1503,1466.5
agars,FALSE,4265933,2664,648,2016,1656
kembo,FALSE,4265865,2496,405,2091,1450.5
spiky,TRUE,4265848,2230,1112,1118,1671
sunna,FALSE,4265386.5,2534,937,1597,1735.5
hallo,FALSE,4265095,2609,705,1904,1657
heels,FALSE,4264863.5,2701,686,2015,1693.5
binks,FALSE,4264652,2284,605,1679,1444.5
coded,FALSE,4264474.5,2547,988,1559,1767.5
steem,FALSE,4264063.5,2639,980,1659,1809.5
mucho,FALSE,4263691,2255,435,1820,1345
lemes,FALSE,4263661,2620,745,1875,1682.5
souts,FALSE,4263540,2415,985,1430,1700
yogee,FALSE,4263528,2446,1094,1352,1770
sutta,FALSE,4263340,2651,866,1785,1758.5
spall,FALSE,4263150,2521,1052,1469,1786.5
allod,FALSE,4263078.5,2600,704,1896,1652
idees,FALSE,4263007.5,2691,585,2106,1638
fugio,FALSE,4262829,2284,605,1679,1444.5
sirih,FALSE,4262020,2481,1028,1453,1754.5
palpi,FALSE,4261843,2550,619,1931,1584.5
rekes,FALSE,4261694,2713,713,2000,1713
fishy,TRUE,4261214,2268,810,1458,1539
block,TRUE,4261174,2238,883,1355,1560.5
linns,FALSE,4261042.5,2463,647,1816,1555
maria,FALSE,4260640,2691,796,1895,1743.5
truss,TRUE,4260361.5,2579,788,1791,1683.5
zaxes,FALSE,4260342,2655,673,1982,1664
filks,FALSE,4259955,2322,541,1781,1431.5
wizen,FALSE,4259375,2482,744,1738,1613
eyers,FALSE,4259360.5,2928,460,2468,1694
lassy,FALSE,4259051.5,2592,1007,1585,1799.5
tenth,TRUE,4258969,2652,808,1844,1730
hells,FALSE,4258575,2701,621,2080,1661
merde,FALSE,4257825,2561,1005,1556,1783
rower,TRUE,4257188,2760,940,1820,1850
penes,FALSE,4256763,2570,877,1693,1723.5
tahas,FALSE,4256016,2573,661,1912,1617
pushy,TRUE,4255870,2217,800,1417,1508.5
banjo,TRUE,4255493,2426,676,1750,1551
beers,FALSE,4255065.5,2778,780,1998,1779
paans,FALSE,4254960,2423,971,1452,1697
pulks,FALSE,4254611,2271,531,1740,1401
karat,FALSE,4254218,2615,903,1712,1759
quins,FALSE,4253910,2301,693,1608,1497
squad,TRUE,4253716,2383,817,1566,1600
forky,FALSE,4253621,2336,997,1339,1666.5
outta,FALSE,4253340,2706,541,2165,1623.5
jawed,FALSE,4253306,2556,786,1770,1671
kraal,FALSE,4252559,2596,913,1683,1754.5
plunk,TRUE,4252200,2203,803,1400,1503
dells,FALSE,4251840,2692,663,2029,1677.5
vexil,FALSE,4251796,2537,611,1926,1574
cheth,FALSE,4251627,2550,797,1753,1673.5
teggs,FALSE,4251545.5,2641,570,2071,1605.5
akees,FALSE,4251407.5,2785,682,2103,1733.5
verra,FALSE,4251228,2951,664,2287,1807.5
sused,FALSE,4251162,2501,1068,1433,1784.5
bawds,FALSE,4251011,2358,608,1750,1483
mingy,FALSE,4250750,2212,888,1324,1550
undee,FALSE,4250397,2433,937,1496,1685
nizam,FALSE,4250351,2439,455,1984,1447
ombus,FALSE,4250264,2313,254,2059,1283.5
cusec,FALSE,4249892.5,2579,813,1766,1696
souls,FALSE,4249880,2396,1008,1388,1702
shris,FALSE,4249644,2481,867,1614,1674
twink,FALSE,4249623,2260,754,1506,1507
dough,TRUE,4249305,2179,770,1409,1474.5
mochy,FALSE,4249193,2215,834,1381,1524.5
heths,FALSE,4249108,2720,486,2234,1603
argal,FALSE,4248980,2694,794,1900,1744
suede,FALSE,4247541.5,2501,1222,1279,1861.5
revel,TRUE,4247492,2690,870,1820,1780
mazut,FALSE,4247355,2366,757,1609,1561.5
geyer,FALSE,4247023,2610,916,1694,1763
filum,FALSE,4247020,2257,574,1683,1415.5
shans,FALSE,4246832,2456,1035,1421,1745.5
blatt,FALSE,4246759,2491,1073,1418,1782
spoor,FALSE,4246540,2474,1015,1459,1744.5
naeve,FALSE,4245809.5,2664,988,1676,1826
wacks,FALSE,4245638,2371,534,1837,1452.5
booai,FALSE,4245440,2496,870,1626,1683
corno,FALSE,4245396,2508,880,1628,1694
palps,FALSE,4245349,2521,644,1877,1582.5
boabs,FALSE,4244788,2467,819,1648,1643
teend,FALSE,4244593.5,2643,868,1775,1755.5
benet,FALSE,4243859,2540,1125,1415,1832.5
honky,FALSE,4243674,2221,906,1315,1563.5
reech,FALSE,4243541.5,2720,815,1905,1767.5
chynd,FALSE,4243330,2164,671,1493,1417.5
gouge,TRUE,4242731.5,2486,1059,1427,1772.5
gouks,FALSE,4242662,2250,650,1600,1450
betes,FALSE,4242652,2608,880,1728,1744
teths,FALSE,4242508,2720,566,2154,1643
asura,FALSE,4242380,2821,538,2283,1679.5
picks,FALSE,4242305,2261,491,1770,1376
props,FALSE,4242145,2474,739,1735,1606.5
chugs,FALSE,4242008,2202,619,1583,1410.5
datto,FALSE,4241825,2619,723,1896,1671
cisco,FALSE,4241033,2386,690,1696,1538
prill,FALSE,4240705,2478,993,1485,1735.5
charr,FALSE,4240527,2573,1013,1560,1793
cinct,FALSE,4240348,2312,944,1368,1628
mungs,FALSE,4240116,2223,544,1679,1383.5
arpas,FALSE,4239577,2710,665,2045,1687.5
muxes,FALSE,4239487,2466,659,1807,1562.5
clach,FALSE,4239460,2384,997,1387,1690.5
exfil,FALSE,4239292,2595,425,2170,1510
miasm,FALSE,4239125.5,2472,829,1643,1650.5
quads,FALSE,4238929,2383,621,1762,1502
brugh,FALSE,4238268,2240,820,1420,1530
tanty,FALSE,4238105,2543,1095,1448,1819
saims,FALSE,4237876,2472,1040,1432,1756
shiso,FALSE,4237548.5,2317,1005,1312,1661
sagos,FALSE,4237217,2500,905,1595,1702.5
chums,FALSE,4237190,2200,611,1589,1405.5
rifer,FALSE,4236346,2747,862,1885,1804.5
rabbi,TRUE,4236266,2660,501,2159,1580.5
apnea,TRUE,4236236,2861,723,2138,1792
geest,FALSE,4235999.5,2641,958,1683,1799.5
issue,TRUE,4235867,2778,636,2142,1707
ydred,FALSE,4235834,2680,625,2055,1652.5
xysti,FALSE,4235400,2386,253,2133,1319.5
ethne,FALSE,4235246,2652,764,1888,1708
thuja,FALSE,4235228,2439,524,1915,1481.5
pucka,FALSE,4235167,2362,503,1859,1432.5
scoot,FALSE,4234989,2406,1035,1371,1720.5
marri,FALSE,4234979,2691,737,1954,1714
mesas,FALSE,4234438,2881,628,2253,1754.5
nelly,FALSE,4234232,2671,917,1754,1794
lilac,TRUE,4234201,2652,596,2056,1624
morra,FALSE,4233939,2717,765,1952,1741
skers,FALSE,4233693,2713,741,1972,1727
goors,FALSE,4233197,2428,826,1602,1627
himbo,FALSE,4233127,2264,414,1850,1339
slags,FALSE,4233109,2475,986,1489,1730.5
seaze,FALSE,4232901,2618,1359,1259,1988.5
dryad,FALSE,4232658.5,2533,688,1845,1610.5
diced,FALSE,4232654.5,2521,805,1716,1663
glees,FALSE,4232157.5,2622,847,1775,1734.5
sorry,TRUE,4232038,2545,1324,1221,1934.5
jigot,FALSE,4231549,2314,674,1640,1494
lilos,FALSE,4231382,2586,570,2016,1578
suits,FALSE,4231316,2389,993,1396,1691
chivs,FALSE,4231212,2241,690,1551,1465.5
barro,FALSE,4231098,2686,850,1836,1768
iliad,FALSE,4231087,2574,782,1792,1678
wived,FALSE,4230981,2416,770,1646,1593
semen,TRUE,4230795,2522,1117,1405,1819.5
mozed,FALSE,4230133,2432,833,1599,1632.5
typey,FALSE,4229914,2486,912,1574,1699
catch,TRUE,4229435,2403,904,1499,1653.5
pyxes,FALSE,4229242,2474,531,1943,1502.5
baals,FALSE,4229018,2442,982,1460,1712
moors,FALSE,4228925,2426,818,1608,1622
glitz,FALSE,4228912,2297,725,1572,1511
pilei,FALSE,4228804,2697,785,1912,1741
whaup,FALSE,4228509,2285,672,1613,1478.5
slams,FALSE,4228291,2473,978,1495,1725.5
zincs,FALSE,4227967,2298,532,1766,1415
blimp,TRUE,4227903,2206,764,1442,1485
muhly,FALSE,4227795,2199,828,1371,1513.5
downy,TRUE,4227717,2204,962,1242,1583
lilts,FALSE,4227512,2580,577,2003,1578.5
piece,TRUE,4227368.5,2497,1097,1400,1797
onned,FALSE,4226782,2649,703,1946,1676
grump,FALSE,4226557,2238,671,1567,1454.5
dimbo,FALSE,4226392,2255,456,1799,1355.5
thoro,FALSE,4226009,2556,747,1809,1651.5
plaas,FALSE,4225852,2521,849,1672,1685
maims,FALSE,4225311.5,2472,781,1691,1626.5
stems,FALSE,4225093,2639,724,1915,1681.5
maill,FALSE,4224664,2502,995,1507,1748.5
obole,FALSE,4224358,2644,887,1757,1765.5
roric,FALSE,4224110,2605,736,1869,1670.5
newer,TRUE,4224103,2637,835,1802,1736
carry,TRUE,4223958,2611,1181,1430,1896
honor,TRUE,4223901,2439,831,1608,1635
gnarr,FALSE,4223833,2596,873,1723,1734.5
motor,TRUE,4223323,2475,841,1634,1658
sarks,FALSE,4222487,2566,924,1642,1745
blebs,FALSE,4222078,2589,611,1978,1600
tamal,FALSE,4221735,2522,833,1689,1677.5
pipas,FALSE,4221645,2520,601,1919,1560.5
bobas,FALSE,4221502,2467,708,1759,1587.5
leaze,FALSE,4221419,2648,1081,1567,1864.5
oonts,FALSE,4221276,2508,634,1874,1571
hoses,FALSE,4221105,2726,782,1944,1754
mufti,FALSE,4220721,2276,468,1808,1372
vrouw,FALSE,4220649,2310,653,1657,1481.5
lorry,TRUE,4220556,2575,1046,1529,1810.5
bitte,FALSE,4220352,2637,1049,1588,1843
pooed,FALSE,4220334,2445,1101,1344,1773
peels,FALSE,4219971.5,2668,759,1909,1713.5
psych,FALSE,4219850,2208,478,1730,1343
volve,FALSE,4219762,2526,904,1622,1715
cinqs,FALSE,4218873,2292,575,1717,1433.5
clepe,FALSE,4218685.5,2498,1050,1448,1774
sluts,FALSE,4218611,2390,907,1483,1648.5
cided,FALSE,4218568.5,2521,911,1610,1716
bonza,FALSE,4218183,2434,675,1759,1554.5
equip,TRUE,4218024,2535,456,2079,1495.5
netty,FALSE,4217697,2690,893,1797,1791.5
whiny,TRUE,4217297,2187,1039,1148,1613
donor,TRUE,4217166,2430,873,1557,1651.5
ozeki,FALSE,4217034,2613,286,2327,1449.5
tapas,FALSE,4216920,2540,710,1830,1625
cruor,FALSE,4216894,2415,974,1441,1694.5
pisky,FALSE,4216783,2230,843,1387,1536.5
penni,FALSE,4215688.5,2599,716,1883,1657.5
preed,FALSE,4215525.5,2609,1022,1587,1815.5
codec,FALSE,4215361.5,2547,901,1646,1724
sneds,FALSE,4215191,2594,735,1859,1664.5
mifty,FALSE,4214861,2236,837,1399,1536.5
aggri,FALSE,4214649.5,2693,383,2310,1538
doses,FALSE,4214370,2717,824,1893,1770.5
snowk,FALSE,4214333,2237,835,1402,1536
swink,FALSE,4214203,2211,971,1240,1591
pheer,FALSE,4214033.5,2618,993,1625,1805.5
solus,FALSE,4213750,2396,875,1521,1635.5
scots,FALSE,4213740,2406,825,1581,1615.5
pells,FALSE,4213683,2668,694,1974,1681
petti,FALSE,4213642,2716,645,2071,1680.5
hence,TRUE,4213376,2433,1026,1407,1729.5
shirr,FALSE,4213263,2481,1140,1341,1810.5
nerve,TRUE,4213106,2592,912,1680,1752
proto,FALSE,4212947,2523,850,1673,1686.5
amuck,FALSE,4212865,2314,609,1705,1461.5
niton,FALSE,4212829.5,2537,612,1925,1574.5
brass,TRUE,4212623.5,2631,954,1677,1792.5
zoism,FALSE,4212431,2271,761,1510,1516
olios,FALSE,4212193,2586,676,1910,1631
fella,TRUE,4211889,2820,716,2104,1768
oidia,FALSE,4211877,2599,540,2059,1569.5
sauna,TRUE,4211721,2534,1081,1453,1807.5
spunk,TRUE,4211532,2173,887,1286,1530
dhows,FALSE,4211122,2234,560,1674,1397
turrs,FALSE,4210918,2579,686,1893,1632.5
yawey,FALSE,4210625,2576,1018,1558,1797
chaco,FALSE,4210613,2409,859,1550,1634
glial,FALSE,4210235.5,2504,901,1603,1702.5
oxlip,FALSE,4209806,2351,381,1970,1366
holla,FALSE,4209511,2609,686,1923,1647.5
unkid,FALSE,4209079,2226,408,1818,1317
sands,FALSE,4208926,2447,914,1533,1680.5
somas,FALSE,4208821,2498,905,1593,1701.5
burqa,FALSE,4207966,2499,586,1913,1542.5
viewy,FALSE,4207922,2463,811,1652,1637
stags,FALSE,4207692,2494,862,1632,1678
smoky,TRUE,4207335,2208,1067,1141,1637.5
casts,FALSE,4207289,2642,757,1885,1699.5
quark,TRUE,4206901,2434,781,1653,1607.5
oxids,FALSE,4206245,2345,426,1919,1385.5
colic,FALSE,4206104.5,2416,778,1638,1597
annul,TRUE,4205396,2564,605,1959,1584.5
renew,TRUE,4205252,2637,821,1816,1729
qursh,FALSE,4205179,2320,682,1638,1501
plumy,FALSE,4205055,2166,940,1226,1553
fifes,FALSE,4205050,2528,717,1811,1622.5
ricin,FALSE,4204654,2482,651,1831,1566.5
hwyls,FALSE,4204572,2256,340,1916,1298
proxy,TRUE,4204406,2310,1020,1290,1665
honan,FALSE,4204274.5,2511,780,1731,1645.5
aland,FALSE,4204248,2477,949,1528,1713
tints,FALSE,4204157,2482,665,1817,1573.5
epoxy,TRUE,4203899,2529,744,1785,1636.5
attic,TRUE,4203809,2671,518,2153,1594.5
carap,FALSE,4203224,2540,884,1656,1712
sordo,FALSE,4203151,2498,935,1563,1716.5
sonsy,FALSE,4202315.5,2258,1319,939,1788.5
stout,TRUE,4202276,2415,1022,1393,1718.5
syces,FALSE,4201738,2539,799,1740,1669
grogs,FALSE,4201697.5,2428,738,1690,1583
rorty,FALSE,4201675,2594,1050,1544,1822
begum,FALSE,4201355,2378,606,1772,1492
xylem,FALSE,4201068,2456,495,1961,1475.5
fundi,FALSE,4200014,2231,541,1690,1386
blabs,FALSE,4199859,2442,741,1701,1591.5
qualm,TRUE,4199578,2341,720,1621,1530.5
mocks,FALSE,4199472,2239,533,1706,1386
licit,FALSE,4198812,2410,757,1653,1583.5
kazis,FALSE,4198660,2411,529,1882,1470
scyes,FALSE,4198296,2539,789,1750,1664
tumpy,FALSE,4198265,2185,810,1375,1497.5
burgh,FALSE,4198166,2240,737,1503,1488.5
tewel,FALSE,4198152,2565,891,1674,1728
hinky,FALSE,4197768,2195,829,1366,1512
smell,TRUE,4197656,2620,899,1721,1759.5
munch,TRUE,4197406,2132,723,1409,1427.5
gooey,TRUE,4197239,2446,1320,1126,1883
rugby,TRUE,4196975,2278,746,1532,1512
rooms,FALSE,4196868,2426,732,1694,1579
inned,FALSE,4195842,2623,696,1927,1659.5
gawcy,FALSE,4195757,2268,961,1307,1614.5
fetta,FALSE,4195354,2839,692,2147,1765.5
anura,FALSE,4195033,2753,609,2144,1681
kembs,FALSE,4194827,2441,383,2058,1412
atuas,FALSE,4194255,2651,582,2069,1616.5
halls,FALSE,4194057,2554,683,1871,1618.5
hoots,FALSE,4193958,2337,767,1570,1552
reddy,FALSE,4193955,2680,855,1825,1767.5
faugh,FALSE,4193900,2252,820,1432,1536
palas,FALSE,4193034,2521,757,1764,1639
ancon,FALSE,4192946.5,2580,546,2034,1563
meuse,FALSE,4192927,2429,1109,1320,1769
adage,TRUE,4192719,2635,968,1667,1801.5
jives,FALSE,4192522,2497,625,1872,1561
naiad,FALSE,4192505,2476,888,1588,1682
bingy,FALSE,4192325,2181,954,1227,1567.5
aulas,FALSE,4192083,2632,638,1994,1635
grana,FALSE,4191511,2596,935,1661,1765.5
avyze,FALSE,4191376,2566,629,1937,1597.5
dinky,FALSE,4191033,2186,871,1315,1528.5
pubco,FALSE,4190684,2191,595,1596,1393
segue,TRUE,4189900,2431,1181,1250,1806
coons,FALSE,4189858,2289,939,1350,1614
powny,FALSE,4189560,2180,993,1187,1586.5
vodun,FALSE,4189265,2199,609,1590,1404
mixed,FALSE,4188749,2408,757,1651,1582.5
situs,FALSE,4188528,2389,797,1592,1593
wispy,TRUE,4188391,2222,779,1443,1500.5
donna,FALSE,4188287.5,2502,775,1727,1638.5
shiai,FALSE,4187172,2553,950,1603,1751.5
volks,FALSE,4187141,2290,525,1765,1407.5
hunks,FALSE,4187134,2206,485,1721,1345.5
peyse,FALSE,4187098,2437,1008,1429,1722.5
jaups,FALSE,4186948,2357,575,1782,1466
sokes,FALSE,4186940,2549,1011,1538,1780
fleet,TRUE,4186654.5,2578,1085,1493,1831.5
slebs,FALSE,4186452,2589,804,1785,1696.5
favus,FALSE,4185174,2340,607,1733,1473.5
wembs,FALSE,4185048,2433,446,1987,1439.5
malms,FALSE,4185017.5,2473,627,1846,1550
agast,FALSE,4184170,2494,884,1610,1689
murre,FALSE,4183797,2648,1032,1616,1840
duett,FALSE,4183748,2550,866,1684,1708
britt,FALSE,4183646,2418,1098,1320,1758
funds,FALSE,4183520,2202,566,1636,1384
miltz,FALSE,4183369,2295,564,1731,1429.5
karks,FALSE,4182995.5,2566,578,1988,1572
alaps,FALSE,4182908,2521,735,1786,1628
filmy,TRUE,4182810,2217,882,1335,1549.5
fight,TRUE,4182739,2200,686,1514,1443
bungs,FALSE,4181691,2192,610,1582,1401
nolls,FALSE,4181672,2489,626,1863,1557.5
bludy,FALSE,4181604,2159,972,1187,1565.5
kapow,FALSE,4181379,2324,531,1793,1427.5
jerky,TRUE,4181025,2539,844,1695,1691.5
lyses,FALSE,4181003,2739,545,2194,1642
dunks,FALSE,4180399,2197,527,1670,1362
bouks,FALSE,4179965,2217,708,1509,1462.5
kente,FALSE,4179908,2475,964,1511,1719.5
dykon,FALSE,4179861,2212,408,1804,1310
yests,FALSE,4179823,2758,503,2255,1630.5
touzy,FALSE,4179534,2249,977,1272,1613
neeld,FALSE,4179148.5,2624,736,1888,1680
whids,FALSE,4178930,2208,598,1610,1403
kindy,FALSE,4178608,2186,794,1392,1490
kaugh,FALSE,4178354,2247,704,1543,1475.5
taths,FALSE,4177990,2573,628,1945,1600.5
spans,FALSE,4177907,2423,952,1471,1687.5
gulfs,FALSE,4177609,2230,484,1746,1357
chomp,FALSE,4177462,2144,710,1434,1427
sabra,FALSE,4176701,2631,943,1688,1787
milky,TRUE,4176506,2212,840,1372,1526
leeps,FALSE,4176351.5,2668,593,2075,1630.5
boxed,FALSE,4176230,2403,900,1503,1651.5
poses,FALSE,4176213,2693,855,1838,1774
gimps,FALSE,4176156,2209,464,1745,1336.5
humid,TRUE,4176013,2151,592,1559,1371.5
tocos,FALSE,4175766,2406,652,1754,1529
arrow,TRUE,4175668,2613,720,1893,1666.5
small,TRUE,4175437,2473,1029,1444,1751
ogees,FALSE,4175253.5,2647,584,2063,1615.5
dewax,FALSE,4174903,2566,550,2016,1558
alamo,FALSE,4174578,2528,775,1753,1651.5
loony,FALSE,4174498,2288,1157,1131,1722.5
niqab,FALSE,4174423,2402,414,1988,1408
pubic,TRUE,4174341,2165,574,1591,1369.5
dools,FALSE,4173563,2309,832,1477,1570.5
chubs,FALSE,4173132,2169,567,1602,1368
khafs,FALSE,4172992,2315,542,1773,1428.5
zooea,FALSE,4172736,2673,908,1765,1790.5
rymme,FALSE,4172672.5,2608,681,1927,1644.5
judas,FALSE,4172553,2381,480,1901,1430.5
grigs,FALSE,4172497.5,2402,760,1642,1581
gulpy,FALSE,4172367,2168,827,1341,1497.5
fawny,FALSE,4172312,2277,1012,1265,1644.5
genes,FALSE,4172296,2524,850,1674,1687
kumis,FALSE,4171657,2222,461,1761,1341.5
gushy,FALSE,4171403,2171,773,1398,1472
rebec,FALSE,4171019,2608,753,1855,1680.5
vamps,FALSE,4170561,2320,494,1826,1407
vixen,TRUE,4170502,2439,705,1734,1572
boors,FALSE,4170500,2395,884,1511,1639.5
blees,FALSE,4169460.5,2589,905,1684,1747
blowy,FALSE,4169340,2199,1007,1192,1603
shott,FALSE,4169054,2337,1146,1191,1741.5
rover,TRUE,4168980,2715,963,1752,1839
gigue,FALSE,4168915,2460,890,1570,1675
windy,TRUE,4168829,2178,857,1321,1517.5
waugh,FALSE,4168575,2239,767,1472,1503
eerie,TRUE,4168533,2540,1059,1481,1799.5
pence,TRUE,4168484,2400,1099,1301,1749.5
razer,FALSE,4168392,2837,950,1887,1893.5
wonks,FALSE,4168167,2237,592,1645,1414.5
menes,FALSE,4168024,2522,842,1680,1682
kight,FALSE,4167193,2195,570,1625,1382.5
mushy,TRUE,4167131,2169,765,1404,1467
mered,FALSE,4166781,2561,948,1613,1754.5
blitz,TRUE,4166215,2264,783,1481,1523.5
flung,TRUE,4166206,2162,725,1437,1443.5
proso,FALSE,4165522,2474,882,1592,1678
emure,FALSE,4165238,2648,851,1797,1749.5
labra,FALSE,4165219,2661,665,1996,1663
addio,FALSE,4164873.5,2599,452,2147,1525.5
rheme,FALSE,4164868.5,2570,918,1652,1744
apage,FALSE,4164728,2611,1009,1602,1810
smalm,FALSE,4164639,2473,915,1558,1694
spumy,FALSE,4164387,2136,1024,1112,1580
slabs,FALSE,4164233,2442,934,1508,1688
whops,FALSE,4163785,2210,557,1653,1383.5
simas,FALSE,4162915,2472,828,1644,1650
sewel,FALSE,4162732,2516,1108,1408,1812
leben,FALSE,4162576,2521,835,1686,1678
libel,TRUE,4161574,2618,821,1797,1719.5
tewit,FALSE,4161572,2564,828,1736,1696
aroma,TRUE,4161234,2717,784,1933,1750.5
zoeae,FALSE,4161172.5,2673,1046,1627,1859.5
durzi,FALSE,4161151,2346,491,1855,1418.5
embow,FALSE,4161045,2488,316,2172,1402
gigas,FALSE,4160937,2474,583,1891,1528.5
sease,FALSE,4160509.5,2583,1510,1073,2046.5
mecca,TRUE,4159449,2711,621,2090,1666
brede,FALSE,4159405.5,2530,1110,1420,1820
bolix,FALSE,4159294,2272,730,1542,1501
smoor,FALSE,4158827,2426,992,1434,1709
rasps,FALSE,4158785,2710,575,2135,1642.5
fique,FALSE,4158748,2396,845,1551,1620.5
imine,FALSE,4158130,2551,944,1607,1747.5
lists,FALSE,4157981,2580,545,2035,1562.5
nonis,FALSE,4157953,2488,649,1839,1568.5
herry,FALSE,4157694,2689,990,1699,1839.5
crewe,FALSE,4157523.5,2535,1091,1444,1813
ataps,FALSE,4157491,2540,611,1929,1575.5
wight,TRUE,4157414,2187,633,1554,1410
kophs,FALSE,4156706,2218,421,1797,1319.5
nahal,FALSE,4156619,2486,669,1817,1577.5
rayah,FALSE,4156614,2542,740,1802,1641
grill,TRUE,4156238,2432,966,1466,1699
wanky,FALSE,4156209,2272,945,1327,1608.5
annoy,TRUE,4155808,2549,863,1686,1706
acini,FALSE,4155762,2554,640,1914,1597
thump,TRUE,4155488,2147,582,1565,1364.5
umpty,FALSE,4155388,2185,632,1553,1408.5
hasta,FALSE,4155259,2573,656,1917,1614.5
nebel,FALSE,4154429,2521,810,1711,1665.5
reiki,FALSE,4154307,2742,679,2063,1710.5
jubes,FALSE,4154100,2425,617,1808,1521
zanze,FALSE,4153841,2550,890,1660,1720
micks,FALSE,4153566,2213,456,1757,1334.5
natty,FALSE,4153179,2543,955,1588,1749
pinky,TRUE,4152876,2162,902,1260,1532
lytta,FALSE,4152874,2641,425,2216,1533
skies,FALSE,4152130,2523,996,1527,1759.5
sixmo,FALSE,4152092,2273,706,1567,1489.5
sobas,FALSE,4152084,2467,901,1566,1684
paisa,FALSE,4151698,2520,947,1573,1733.5
lumpy,TRUE,4151363,2166,749,1417,1457.5
panni,FALSE,4151170.5,2452,778,1674,1615
derry,FALSE,4150959,2680,1032,1648,1856
shoot,TRUE,4149837,2337,1139,1198,1738
gesso,FALSE,4149826.5,2647,666,1981,1656.5
bunje,FALSE,4149767,2357,924,1433,1640.5
bufos,FALSE,4149672,2222,552,1670,1387
glazy,FALSE,4149564,2309,1007,1302,1658
jobed,FALSE,4149268,2393,792,1601,1592.5
palls,FALSE,4149165,2521,756,1765,1638.5
poots,FALSE,4149066,2304,840,1464,1572
ennui,TRUE,4148630,2710,391,2319,1550.5
snaps,FALSE,4148627,2423,846,1577,1634.5
agape,TRUE,4148575,2611,934,1677,1772.5
talpa,FALSE,4148451,2570,679,1891,1624.5
chimp,FALSE,4148262,2118,732,1386,1425
indie,FALSE,4148108,2623,778,1845,1700.5
robot,TRUE,4147992,2444,826,1618,1635
buiks,FALSE,4147741,2191,716,1475,1453.5
finks,FALSE,4147586,2224,568,1656,1396
zupas,FALSE,4146736,2365,446,1919,1405.5
brool,FALSE,4146639,2425,972,1453,1698.5
cedes,FALSE,4146333,2492,869,1623,1680.5
reedy,TRUE,4146206.5,2680,957,1723,1818.5
leccy,FALSE,4146066,2569,902,1667,1735.5
gamme,FALSE,4145947.5,2563,972,1591,1767.5
rhumb,FALSE,4145154,2238,493,1745,1365.5
wagyu,FALSE,4145042,2277,458,1819,1367.5
dowps,FALSE,4145005,2201,502,1699,1351.5
meets,FALSE,4144892.5,2639,701,1938,1670
dross,TRUE,4144818.5,2498,829,1669,1663.5
sucky,FALSE,4144527,2142,1027,1115,1584.5
flock,TRUE,4144108,2178,846,1332,1512
offie,FALSE,4144010,2583,656,1927,1619.5
teems,FALSE,4143885.5,2639,672,1967,1655.5
stull,FALSE,4143555,2390,926,1464,1658
slily,FALSE,4143525.5,2330,1359,971,1844.5
peery,FALSE,4143289.5,2656,1077,1579,1866.5
eigne,FALSE,4142723,2553,947,1606,1750
dinna,FALSE,4142381.5,2476,698,1778,1587
punks,FALSE,4142242,2173,558,1615,1365.5
kokra,FALSE,4141473,2621,527,2094,1574
matai,FALSE,4141473,2521,696,1825,1608.5
swies,FALSE,4141458,2515,1030,1485,1772.5
tinct,FALSE,4141153,2312,895,1417,1603.5
bocks,FALSE,4141047,2208,599,1609,1403.5
sikes,FALSE,4141034,2523,934,1589,1728.5
hests,FALSE,4141025,2720,566,2154,1643
araks,FALSE,4140958,2566,806,1760,1686
pujas,FALSE,4140952,2357,530,1827,1443.5
supes,FALSE,4140332,2477,964,1513,1720.5
skeet,FALSE,4140303.5,2543,1124,1419,1833.5
kutch,FALSE,4139422,2153,608,1545,1380.5
bunch,TRUE,4138981,2101,789,1312,1445
merge,TRUE,4138930,2491,1012,1479,1751.5
stabs,FALSE,4138816,2461,810,1651,1635.5
spues,FALSE,4138787,2477,946,1531,1711.5
jugal,FALSE,4138159,2341,592,1749,1466.5
feers,FALSE,4137999.5,2718,743,1975,1730.5
fiefs,FALSE,4137959,2528,586,1942,1557
raffs,FALSE,4137606,2571,505,2066,1538
hawks,FALSE,4137559,2302,490,1812,1396
anyon,FALSE,4137296.5,2549,519,2030,1534
sapan,FALSE,4137152,2423,1021,1402,1722
deens,FALSE,4136906.5,2594,748,1846,1671
knows,FALSE,4136636,2237,412,1825,1324.5
molal,FALSE,4136417,2528,817,1711,1672.5
klett,FALSE,4136366,2573,790,1783,1681.5
never,TRUE,4135895,2592,858,1734,1725
nills,FALSE,4135766,2463,549,1914,1506
flubs,FALSE,4135707,2197,562,1635,1379.5
fungo,FALSE,4135663,2187,595,1592,1391
pools,FALSE,4135406,2285,863,1422,1574
whips,FALSE,4134585,2184,579,1605,1381.5
wases,FALSE,4133640,2777,821,1956,1799
twite,FALSE,4133582,2564,1022,1542,1793
chara,FALSE,4133440,2573,865,1708,1719
coqui,FALSE,4133278,2254,571,1683,1412.5
lucky,TRUE,4133045,2172,749,1423,1460.5
gopik,FALSE,4132086,2168,723,1445,1445.5
mooed,FALSE,4131595,2397,1066,1331,1731.5
greed,TRUE,4131058.5,2563,995,1568,1779
kedgy,FALSE,4131015,2345,777,1568,1561
abbot,TRUE,4130924,2516,599,1917,1557.5
dawks,FALSE,4130824,2293,532,1761,1412.5
augur,TRUE,4130720,2503,688,1815,1595.5
pises,FALSE,4130307,2667,778,1889,1722.5
karzy,FALSE,4130246,2400,871,1529,1635.5
zymes,FALSE,4129833,2424,441,1983,1432.5
sweet,TRUE,4129631.5,2535,1158,1377,1846.5
sabal,FALSE,4129578,2442,1046,1396,1744
vulgo,FALSE,4129312,2227,475,1752,1351
locos,FALSE,4128864,2387,591,1796,1489
gojis,FALSE,4128771,2265,591,1674,1428
gulph,FALSE,4128713,2130,602,1528,1366
nulla,FALSE,4128628,2564,561,2003,1562.5
shots,FALSE,4128588,2337,929,1408,1633
crack,TRUE,4128452,2396,1037,1359,1716.5
pownd,FALSE,4128188,2133,747,1386,1440
seifs,FALSE,4128064,2528,945,1583,1736.5
yucko,FALSE,4127459,2197,361,1836,1279
hatch,TRUE,4127280,2403,775,1628,1589
numbs,FALSE,4127112,2190,344,1846,1267
intil,FALSE,4126761,2512,546,1966,1529
manat,FALSE,4126186,2424,966,1458,1695
fetes,FALSE,4125586,2548,843,1705,1695.5
abbey,TRUE,4125434,2649,896,1753,1772.5
dudes,FALSE,4124982,2501,726,1775,1613.5
mells,FALSE,4124944,2620,659,1961,1639.5
geode,FALSE,4124891,2399,1094,1305,1746.5
ryper,FALSE,4124860,2656,716,1940,1686
rorid,FALSE,4124153,2527,823,1704,1675
shuck,TRUE,4124139,2104,940,1164,1522
wilja,FALSE,4123981,2425,463,1962,1444
elude,TRUE,4123568,2531,931,1600,1731
river,TRUE,4123074,2689,886,1803,1787.5
colon,TRUE,4122816,2319,851,1468,1585
ahuru,FALSE,4122535,2582,603,1979,1592.5
vizor,FALSE,4122506,2341,600,1741,1470.5
winks,FALSE,4122261,2211,515,1696,1363
johns,FALSE,4121406,2247,526,1721,1386.5
wedgy,FALSE,4121236,2337,840,1497,1588.5
dwaum,FALSE,4121015,2228,586,1642,1407
umiaq,FALSE,4120532,2340,500,1840,1420
thana,FALSE,4120442,2505,846,1659,1675.5
toyos,FALSE,4120116,2375,625,1750,1500
cleep,FALSE,4120114.5,2498,950,1548,1724
quags,FALSE,4120034,2313,628,1685,1470.5
karas,FALSE,4119958,2566,686,1880,1626
fille,FALSE,4119821,2558,1036,1522,1797
unaus,FALSE,4119727,2534,545,1989,1539.5
chica,FALSE,4119685,2383,824,1559,1603.5
touts,FALSE,4119470,2415,768,1647,1591.5
sumph,FALSE,4119191,2098,802,1296,1450
lyssa,FALSE,4118981.5,2592,426,2166,1509
aidoi,FALSE,4118721,2599,561,2038,1580
soyuz,FALSE,4118468,2200,760,1440,1480
sessa,FALSE,4118232.5,2583,923,1660,1753
doped,FALSE,4118170.5,2445,884,1561,1664.5
desis,FALSE,4118140,2691,627,2064,1659
tweel,FALSE,4118061.5,2565,844,1721,1704.5
argan,FALSE,4117362,2596,768,1828,1682
jihad,FALSE,4117114,2332,512,1820,1422
barby,FALSE,4116910,2430,1028,1402,1729
maqui,FALSE,4115847,2340,505,1835,1422.5
jorum,FALSE,4115530,2292,586,1706,1439
bosky,FALSE,4115525,2177,951,1226,1564
quoth,TRUE,4115398,2205,731,1474,1468
fosse,FALSE,4115299.5,2554,1090,1464,1822
flick,TRUE,4114908,2152,868,1284,1510
zebus,FALSE,4114728,2433,420,2013,1426.5
gaita,FALSE,4114656,2523,888,1635,1705.5
sleek,TRUE,4114545.5,2524,1175,1349,1849.5
taiga,FALSE,4114195,2523,859,1664,1691
farro,FALSE,4114032,2626,813,1813,1719.5
murky,TRUE,4113632,2211,875,1336,1543
naams,FALSE,4113429,2375,752,1623,1563.5
woful,FALSE,4113409,2179,625,1554,1402
salpa,FALSE,4113031,2521,896,1625,1708.5
perry,FALSE,4112802,2656,1063,1593,1859.5
rehem,FALSE,4111782,2570,716,1854,1643
palsa,FALSE,4111404,2521,793,1728,1657
irids,FALSE,4111379,2472,672,1800,1572
smirs,FALSE,4111348,2400,858,1542,1629
newie,FALSE,4110986,2447,887,1560,1667
flimp,FALSE,4110837,2146,727,1419,1436.5
sekos,FALSE,4110730,2549,788,1761,1668.5
ekkas,FALSE,4110558,2785,293,2492,1539
pasta,TRUE,4110367,2540,729,1811,1634.5
inurn,FALSE,4110288.5,2491,568,1923,1529.5
ketes,FALSE,4110040,2543,727,1816,1635
benes,FALSE,4109599,2491,908,1583,1699.5
tolly,FALSE,4109399,2405,1066,1339,1735.5
swung,TRUE,4109183,2119,798,1321,1458.5
choky,FALSE,4108911,2119,1005,1114,1562
bushy,TRUE,4108706,2138,831,1307,1484.5
galas,FALSE,4108567,2475,730,1745,1602.5
allel,FALSE,4108180.5,2613,928,1685,1770.5
dungy,FALSE,4108072,2094,876,1218,1485
zazen,FALSE,4107732,2550,766,1784,1658
bulks,FALSE,4107447,2192,562,1630,1377
reefs,FALSE,4107103.5,2718,595,2123,1656.5
sechs,FALSE,4107086,2501,728,1773,1614.5
hadji,FALSE,4106901,2332,461,1871,1396.5
sekts,FALSE,4106860,2543,795,1748,1669
pross,FALSE,4106661.5,2474,860,1614,1667
byked,FALSE,4106286,2312,644,1668,1478
hodja,FALSE,4105861,2358,489,1869,1423.5
blunk,FALSE,4105036,2124,834,1290,1479
faena,FALSE,4104556,2722,863,1859,1792.5
agora,TRUE,4104414,2719,613,2106,1666
gundy,FALSE,4104343,2094,873,1221,1483.5
malas,FALSE,4104295,2473,722,1751,1597.5
pinna,FALSE,4104224.5,2452,729,1723,1590.5
sieve,TRUE,4104168.5,2470,1215,1255,1842.5
jibed,FALSE,4103362,2367,715,1652,1541
fitte,FALSE,4103286,2577,1012,1565,1794.5
ruffe,FALSE,4102918,2557,775,1782,1666
tratt,FALSE,4102852,2413,1115,1298,1764
shool,FALSE,4102847,2318,1042,1276,1680
cepes,FALSE,4102536,2468,852,1616,1660
zupan,FALSE,4102388,2297,540,1757,1418.5
pitta,FALSE,4102178,2569,658,1911,1613.5
oboes,FALSE,4101824,2614,655,1959,1634.5
xerox,FALSE,4101405,2603,545,2058,1574
nomen,FALSE,4101036.5,2577,825,1752,1701
milia,FALSE,4100875,2502,643,1859,1572.5
ytost,FALSE,4100557,2375,751,1624,1563
loofa,FALSE,4100524,2437,710,1727,1573.5
arbas,FALSE,4100385,2631,664,1967,1647.5
pesos,FALSE,4100003,2693,632,2061,1662.5
aurum,FALSE,4099789,2501,614,1887,1557.5
raree,FALSE,4099784,2802,1314,1488,2058
reeks,FALSE,4099638.5,2713,615,2098,1664
shits,FALSE,4099388,2311,951,1360,1631
podgy,FALSE,4099291,2106,936,1170,1521
ranga,FALSE,4099080,2596,688,1908,1642
peens,FALSE,4098749.5,2570,779,1791,1674.5
inrun,FALSE,4098600.5,2491,496,1995,1493.5
dorrs,FALSE,4098399,2498,741,1757,1619.5
djins,FALSE,4098191,2212,597,1615,1404.5
etude,TRUE,4098151,2550,807,1743,1678.5
soths,FALSE,4098150,2337,820,1517,1578.5
yirrs,FALSE,4098026,2519,559,1960,1539
aroba,FALSE,4097176,2686,740,1946,1713
outro,FALSE,4097044,2634,548,2086,1591
pests,FALSE,4096133,2687,639,2048,1663
afars,FALSE,4095925,2571,644,1927,1607.5
pluck,TRUE,4095882,2101,773,1328,1437
dryly,TRUE,4095857,2272,933,1339,1602.5
frass,FALSE,4095557.5,2571,917,1654,1744
heave,TRUE,4094429,2493,1088,1405,1790.5
eensy,FALSE,4094071,2641,988,1653,1814.5
conic,TRUE,4093735.5,2318,805,1513,1561.5
heled,FALSE,4093712,2453,859,1594,1656
brill,FALSE,4093541,2399,1024,1375,1711.5
enfix,FALSE,4093265,2497,350,2147,1423.5
sorbs,FALSE,4093242,2395,868,1527,1631.5
harry,TRUE,4093176,2542,1052,1490,1797
boyfs,FALSE,4092862,2182,552,1630,1367
lieve,FALSE,4092686.5,2500,937,1563,1718.5
pawks,FALSE,4092667,2269,563,1706,1416
gangs,FALSE,4092532.5,2377,670,1707,1523.5
conin,FALSE,4091862.5,2318,904,1414,1611
loops,FALSE,4091786,2285,697,1588,1491
limma,FALSE,4091442.5,2502,483,2019,1492.5
adeem,FALSE,4091431.5,2633,698,1935,1665.5
soaks,FALSE,4091425,2402,1043,1359,1722.5
sybow,FALSE,4091253,2169,595,1574,1382
sangs,FALSE,4090031,2377,921,1456,1649
didst,FALSE,4089811,2302,812,1490,1557
ariki,FALSE,4089487,2595,740,1855,1667.5
saxes,FALSE,4089402,2620,1036,1584,1828
steek,FALSE,4089128.5,2543,1051,1492,1797
aliya,FALSE,4088823,2621,675,1946,1648
boost,TRUE,4088737,2225,1120,1105,1672.5
regur,FALSE,4088625,2650,708,1942,1679
bedad,FALSE,4088600.5,2602,771,1831,1686.5
vouch,TRUE,4088082,2106,778,1328,1442
nyala,FALSE,4087941,2524,593,1931,1558.5
hided,FALSE,4087786.5,2452,782,1670,1617
selfs,FALSE,4087770,2529,791,1738,1660
deave,FALSE,4087694,2484,1130,1354,1807
lamas,FALSE,4087563,2473,652,1821,1562.5
moses,FALSE,4087474,2645,820,1825,1732.5
lumme,FALSE,4087206.5,2459,827,1632,1643
beets,FALSE,4086467.5,2608,767,1841,1687.5
thill,FALSE,4085169,2341,877,1464,1609
sazes,FALSE,4084880,2618,1035,1583,1826.5
ahead,TRUE,4084682,2714,743,1971,1728.5
basal,TRUE,4084678,2442,876,1566,1659
tolyl,FALSE,4084368,2405,699,1706,1552
sorgo,FALSE,4084256,2428,942,1486,1685
druid,TRUE,4084032.5,2311,819,1492,1565
skatt,FALSE,4083342,2396,1075,1321,1735.5
elver,FALSE,4083072,2690,852,1838,1771
dawed,FALSE,4083016.5,2529,877,1652,1703
sweel,FALSE,4082641.5,2516,1061,1455,1788.5
oxims,FALSE,4082532,2273,425,1848,1349
fungi,TRUE,4081119,2161,548,1613,1354.5
jokey,FALSE,4080960,2375,993,1382,1684
needs,FALSE,4080931.5,2594,561,2033,1577.5
spoot,FALSE,4080912,2304,1056,1248,1680
hecht,FALSE,4080804,2550,648,1902,1599
comby,FALSE,4079837,2103,926,1177,1514.5
kiaat,FALSE,4079359,2425,945,1480,1685
kempy,FALSE,4079313,2319,737,1582,1528
saiga,FALSE,4078775,2474,1076,1398,1775
creek,TRUE,4078696.5,2543,1073,1470,1808
colls,FALSE,4077857,2387,787,1600,1587
priss,FALSE,4077461.5,2448,882,1566,1665
deuce,TRUE,4076048,2331,1094,1237,1712.5
repeg,FALSE,4075987,2539,764,1775,1651.5
sylis,FALSE,4075888,2330,695,1635,1512.5
molla,FALSE,4075880,2528,724,1804,1626
toyon,FALSE,4075768,2307,719,1588,1513
berme,FALSE,4075687,2458,1070,1388,1764
konbu,FALSE,4075547,2149,463,1686,1306
eaves,FALSE,4075095,2732,779,1953,1755.5
yumps,FALSE,4074739,2136,339,1797,1237.5
gerbe,FALSE,4074326,2460,968,1492,1714
solds,FALSE,4074313,2309,862,1447,1585.5
tibia,TRUE,4074308,2490,630,1860,1560
skene,FALSE,4074082.5,2426,1159,1267,1792.5
snags,FALSE,4074077,2377,872,1505,1624.5
nadas,FALSE,4074050,2447,615,1832,1531
vives,FALSE,4073433,2470,648,1822,1559
booed,FALSE,4073170,2366,1132,1234,1749
esker,FALSE,4072859,2713,630,2083,1671.5
rusts,FALSE,4072857,2579,546,2033,1562.5
stood,TRUE,4072327,2328,937,1391,1632.5
gigot,FALSE,4072023,2287,769,1518,1528
cobza,FALSE,4071928,2332,618,1714,1475
pitot,FALSE,4071808,2333,840,1493,1586.5
fusee,FALSE,4071803,2338,1144,1194,1741
faded,FALSE,4071552.5,2542,951,1591,1746.5
ydrad,FALSE,4071298,2533,470,2063,1501.5
medle,FALSE,4071181,2372,1010,1362,1691
leese,FALSE,4070638.5,2322,1102,1220,1712
revue,TRUE,4070391,2499,902,1597,1700.5
fryer,FALSE,4070132,2517,962,1555,1739.5
alang,FALSE,4069981,2407,872,1535,1639.5
scurs,FALSE,4069882,2360,759,1601,1559.5
porno,FALSE,4069722,2406,824,1582,1615
phese,FALSE,4069641.5,2399,1058,1341,1728.5
flail,TRUE,4069604.5,2411,958,1453,1684.5
womyn,FALSE,4069260,2132,556,1576,1344
talma,FALSE,4069083,2522,697,1825,1609.5
kynds,FALSE,4068990,2157,287,1870,1222
skeos,FALSE,4068965,2549,721,1828,1635
aloha,FALSE,4068887,2609,678,1931,1643.5
benni,FALSE,4068524.5,2520,747,1773,1633.5
redry,FALSE,4068471,2680,938,1742,1809
breed,TRUE,4068361.5,2530,1053,1477,1791.5
kanji,FALSE,4068337,2335,476,1859,1405.5
cylix,FALSE,4067668,2197,499,1698,1348
gyved,FALSE,4067511,2292,623,1669,1457.5
feyer,FALSE,4067260,2517,937,1580,1727
tuath,FALSE,4066978,2412,920,1492,1666
egers,FALSE,4066788.5,2811,449,2362,1630
gowds,FALSE,4066726,2155,525,1630,1340
fichu,FALSE,4066600,2138,423,1715,1280.5
fritt,FALSE,4066580,2358,1061,1297,1709.5
bells,FALSE,4066519,2589,725,1864,1657
bunko,FALSE,4066116,2149,611,1538,1380
jucos,FALSE,4065972,2223,430,1793,1326.5
piped,FALSE,4065869,2419,838,1581,1628.5
gonna,FALSE,4065663.5,2432,779,1653,1605.5
raggy,FALSE,4065635.5,2463,916,1547,1689.5
afoot,TRUE,4065565,2456,778,1678,1617
imams,FALSE,4065558,2472,483,1989,1477.5
moron,TRUE,4065103,2358,811,1547,1584.5
skets,FALSE,4065095,2543,728,1815,1635.5
galls,FALSE,4064698,2475,729,1746,1602
fungs,FALSE,4064625,2132,573,1559,1352.5
teffs,FALSE,4064576,2548,487,2061,1517.5
skimp,TRUE,4064486,2111,766,1345,1438.5
error,TRUE,4064363,2566,846,1720,1706
abbed,FALSE,4064062,2602,650,1952,1626
bough,TRUE,4063984,2076,832,1244,1454
lezza,FALSE,4063926,2648,425,2223,1536.5
gotta,FALSE,4063617,2549,708,1841,1628.5
whyda,FALSE,4063542,2269,389,1880,1329
tilly,FALSE,4063493,2379,989,1390,1684
conns,FALSE,4063368.5,2289,834,1455,1561.5
aidas,FALSE,4063184,2544,617,1927,1580.5
mooli,FALSE,4063161,2266,803,1463,1534.5
sunis,FALSE,4062503,2272,885,1387,1578.5
glyph,TRUE,4061734,2090,534,1556,1312
cotts,FALSE,4061322,2406,763,1643,1584.5
conto,FALSE,4061209,2338,813,1525,1575.5
duchy,TRUE,4060609,2071,745,1326,1408
malls,FALSE,4060426,2473,721,1752,1597
moots,FALSE,4060327,2256,805,1451,1530.5
whigs,FALSE,4060035,2138,605,1533,1371.5
theed,FALSE,4059989.5,2472,906,1566,1689
spots,FALSE,4059663,2304,846,1458,1575
sonny,FALSE,4059490.5,2258,1330,928,1794
fuzes,FALSE,4059474,2373,687,1686,1530
broos,FALSE,4059369,2395,852,1543,1623.5
tooms,FALSE,4059320,2256,776,1480,1516
wynds,FALSE,4059211,2149,350,1799,1249.5
foxed,FALSE,4059164,2343,863,1480,1603
leech,TRUE,4059091.5,2531,798,1733,1664.5
coyly,TRUE,4059090,2186,1032,1154,1609
hoons,FALSE,4059076,2220,810,1410,1515
tossy,FALSE,4058971.5,2375,1043,1332,1709
hench,FALSE,4058745,2433,741,1692,1587
stuns,FALSE,4058312,2292,826,1466,1559
gunge,FALSE,4057844.5,2363,940,1423,1651.5
gunks,FALSE,4057775,2127,531,1596,1329
ammos,FALSE,4057229.5,2498,408,2090,1453
zygal,FALSE,4057155,2309,412,1897,1360.5
rondo,FALSE,4057050,2430,650,1780,1540
agria,FALSE,4056872,2693,538,2155,1615.5
smirr,FALSE,4056625,2400,1034,1366,1717
yucks,FALSE,4056421,2142,339,1803,1240.5
teddy,TRUE,4056407,2510,899,1611,1704.5
kikes,FALSE,4056113,2523,588,1935,1555.5
glass,TRUE,4056107.5,2475,830,1645,1652.5
sinus,FALSE,4055475,2272,825,1447,1548.5
whims,FALSE,4055217,2136,597,1539,1366.5
karoo,FALSE,4054993,2621,677,1944,1649
bocce,FALSE,4054862,2444,1084,1360,1764
saman,FALSE,4054697,2375,1024,1351,1699.5
odors,FALSE,4054660,2498,493,2005,1495.5
slops,FALSE,4054533,2285,897,1388,1591
tohos,FALSE,4054472,2337,605,1732,1471
koori,FALSE,4054382,2359,706,1653,1532.5
yedes,FALSE,4054349,2461,677,1784,1569
squab,FALSE,4053962,2280,710,1570,1495
sedge,FALSE,4053232,2344,1183,1161,1763.5
grrls,FALSE,4052786,2403,743,1660,1573
neume,FALSE,4052678,2361,936,1425,1648.5
flees,FALSE,4052394.5,2529,868,1661,1698.5
cooly,FALSE,4052140,2186,1247,939,1716.5
hurra,FALSE,4052090,2582,634,1948,1608
keyer,FALSE,4051714,2512,821,1691,1666.5
canny,TRUE,4051410.5,2324,1187,1137,1755.5
wroot,FALSE,4051238,2371,979,1392,1675
vodka,TRUE,4051104,2303,516,1787,1409.5
gools,FALSE,4050939,2239,836,1403,1537.5
hythe,FALSE,4050918,2519,655,1864,1587
wingy,FALSE,4049934,2108,864,1244,1486
dosas,FALSE,4049834,2570,669,1901,1619.5
shill,FALSE,4049749,2292,1094,1198,1693
risus,FALSE,4049679,2559,505,2054,1532
slews,FALSE,4049503,2516,805,1711,1660.5
catty,TRUE,4049364,2441,1116,1325,1778.5
tinny,FALSE,4049004.5,2281,1036,1245,1658.5
parry,TRUE,4048284,2509,1125,1384,1817
gyoza,FALSE,4048279,2334,466,1868,1400
lagan,FALSE,4047803,2407,752,1655,1579.5
stunt,TRUE,4047690,2292,1043,1249,1667.5
rammy,FALSE,4047404.5,2461,902,1559,1681.5
folky,FALSE,4046921,2147,946,1201,1546.5
frump,FALSE,4046794,2145,692,1453,1418.5
neive,FALSE,4046700,2402,1015,1387,1708.5
mools,FALSE,4046667,2237,828,1409,1532.5
waded,FALSE,4046227.5,2529,898,1631,1713.5
gayly,TRUE,4045931,2274,974,1300,1624
sloop,TRUE,4045872,2285,999,1286,1642
balas,FALSE,4045870,2442,788,1654,1615
ephah,FALSE,4045489,2690,444,2246,1567
durra,FALSE,4045355,2573,676,1897,1624.5
wryer,FALSE,4044807,2504,909,1595,1706.5
tythe,FALSE,4044318,2519,735,1784,1627
causa,FALSE,4044116,2432,902,1530,1667
sexer,FALSE,4044094,2548,1150,1398,1849
karri,FALSE,4043942,2595,650,1945,1622.5
hansa,FALSE,4043927,2456,747,1709,1601.5
matts,FALSE,4043891,2492,697,1795,1594.5
specs,FALSE,4043808,2468,792,1676,1630
ginzo,FALSE,4043576,2205,534,1671,1369.5
vivat,FALSE,4043157,2372,710,1662,1541
juvie,FALSE,4042992,2336,837,1499,1586.5
skats,FALSE,4042876,2396,858,1538,1627
hoord,FALSE,4042244,2259,862,1397,1560.5
achar,FALSE,4042021,2573,565,2008,1569
ledge,TRUE,4041750,2374,905,1469,1639.5
staff,TRUE,4041690,2401,811,1590,1606
bundy,FALSE,4041646,2061,931,1130,1496
mises,FALSE,4041568,2619,743,1876,1681
hiois,FALSE,4041564,2317,709,1608,1513
sypes,FALSE,4041348,2437,801,1636,1619
hulky,FALSE,4040563,2103,786,1317,1444.5
vases,FALSE,4040245,2732,781,1951,1756.5
amain,FALSE,4039827,2404,774,1630,1589
yfere,FALSE,4039718.5,2517,767,1750,1642
intis,FALSE,4039491,2482,426,2056,1454
triff,FALSE,4039414,2358,743,1615,1550.5
pupal,TRUE,4039341,2360,705,1655,1532.5
zilch,FALSE,4037742,2157,608,1549,1382.5
arere,FALSE,4037468.5,2802,1161,1641,1981.5
lamia,FALSE,4037208,2502,675,1827,1588.5
again,TRUE,4036837,2406,748,1658,1577
fatal,TRUE,4036758,2431,870,1561,1650.5
neeps,FALSE,4036586.5,2570,542,2028,1556
bajus,FALSE,4036454,2278,598,1680,1438
holos,FALSE,4036382,2318,628,1690,1473
babul,FALSE,4035958,2281,772,1509,1526.5
kybos,FALSE,4035956,2177,268,1909,1222.5
humps,FALSE,4035941,2098,402,1696,1250
domed,FALSE,4035715.5,2397,887,1510,1642
breme,FALSE,4035692.5,2458,1109,1349,1783.5
rakia,FALSE,4035241,2595,643,1952,1619
bulgy,FALSE,4035120,2089,911,1178,1500
aloof,TRUE,4034784,2437,744,1693,1590.5
scads,FALSE,4034677,2345,818,1527,1581.5
dildo,FALSE,4034463,2338,552,1786,1445
grebe,FALSE,4034331.5,2460,1007,1453,1733.5
sofas,FALSE,4034204,2407,869,1538,1638
spool,TRUE,4033922,2285,959,1326,1622
aheap,FALSE,4032810,2690,681,2009,1685.5
gighe,FALSE,4032631,2382,836,1546,1609
swats,FALSE,4032204,2388,892,1496,1640
gadjo,FALSE,4032086,2279,554,1725,1416.5
cills,FALSE,4031951,2361,710,1651,1535.5
topoi,FALSE,4031870,2333,629,1704,1481
awarn,FALSE,4031703,2490,774,1716,1632
riggs,FALSE,4031687.5,2402,486,1916,1444
pasts,FALSE,4031615,2540,701,1839,1620.5
atigi,FALSE,4031470,2523,571,1952,1547
ripps,FALSE,4031197,2448,451,1997,1449.5
sewen,FALSE,4031114,2418,1082,1336,1750
weest,FALSE,4030911.5,2535,926,1609,1730.5
xylic,FALSE,4030863,2197,324,1873,1260.5
dumka,FALSE,4030479,2236,477,1759,1356.5
spits,FALSE,4030463,2278,868,1410,1573
napas,FALSE,4030253,2423,598,1825,1510.5
teene,FALSE,4030083.5,2273,1174,1099,1723.5
tabla,FALSE,4029863,2491,736,1755,1613.5
dolos,FALSE,4029647,2309,670,1639,1489.5
pocky,FALSE,4029271,2086,896,1190,1491
dumps,FALSE,4029206,2089,444,1645,1266.5
stops,FALSE,4029116,2304,773,1531,1538.5
odeon,FALSE,4028977,2649,500,2149,1574.5
silds,FALSE,4028407,2283,785,1498,1534
homme,FALSE,4028324.5,2406,901,1505,1653.5
silly,TRUE,4028073,2330,1206,1124,1768
rigor,TRUE,4027841,2457,718,1739,1587.5
snebs,FALSE,4027420,2491,690,1801,1590.5
theme,TRUE,4027320.5,2400,962,1438,1681
slaws,FALSE,4027284,2369,935,1434,1652
elmen,FALSE,4026725,2552,782,1770,1667
talak,FALSE,4026375,2426,841,1585,1633.5
sakis,FALSE,4026192,2376,876,1500,1626
dodge,TRUE,4025572,2399,965,1434,1682
await,TRUE,4025563,2417,903,1514,1660
wawls,FALSE,4025532.5,2369,611,1758,1490
chunk,TRUE,4025395,2036,802,1234,1419
slips,FALSE,4025333,2259,919,1340,1589
piani,FALSE,4024962,2452,844,1608,1648
celeb,FALSE,4024740,2419,881,1538,1650
jukes,FALSE,4024420,2360,572,1788,1466
nurrs,FALSE,4024251,2462,574,1888,1518
stews,FALSE,4024086,2535,681,1854,1608
merry,TRUE,4024063,2608,1028,1580,1818
novum,FALSE,4024031,2127,489,1638,1308
visie,FALSE,4023540,2470,907,1563,1688.5
floor,TRUE,4022978,2365,925,1440,1645
plops,FALSE,4022932,2285,673,1612,1479
basso,FALSE,4022611.5,2467,786,1681,1626.5
roofs,FALSE,4022538,2335,699,1636,1517
ghazi,FALSE,4022519,2270,597,1673,1433.5
gross,TRUE,4022194.5,2428,833,1595,1630.5
dicky,FALSE,4021522,2084,788,1296,1436
cowks,FALSE,4021359,2135,594,1541,1364.5
katal,FALSE,4021212,2426,754,1672,1590
jingo,FALSE,4021141,2197,495,1702,1346
banal,TRUE,4020771,2374,935,1439,1654.5
stoop,TRUE,4020455,2304,875,1429,1589.5
guimp,FALSE,4020049,2048,691,1357,1369.5
imari,FALSE,4019986,2691,542,2149,1616.5
joked,FALSE,4019588,2328,747,1581,1537.5
veers,FALSE,4019279.5,2660,650,2010,1655
idiot,TRUE,4019072,2357,705,1652,1531
orlop,FALSE,4018928,2504,608,1896,1556
stopt,FALSE,4018494,2304,990,1314,1647
akela,FALSE,4018291,2815,554,2261,1684.5
ootid,FALSE,4017867,2357,707,1650,1532
hucks,FALSE,4017623,2104,402,1702,1253
roopy,FALSE,4017296,2273,1042,1231,1657.5
varas,FALSE,4016784,2513,709,1804,1611
kaiks,FALSE,4016589.5,2376,681,1695,1528.5
fowth,FALSE,4016558,2120,719,1401,1419.5
duads,FALSE,4016471,2354,709,1645,1531.5
bless,TRUE,4015629.5,2589,758,1831,1673.5
skell,FALSE,4015456,2524,871,1653,1697.5
sorbo,FALSE,4015380,2395,890,1505,1642.5
topos,FALSE,4015376,2304,654,1650,1479
whift,FALSE,4015147,2094,781,1313,1437.5
rooks,FALSE,4015073,2330,719,1611,1524.5
poons,FALSE,4014184,2187,883,1304,1535
wifty,FALSE,4014045,2132,813,1319,1472.5
tilth,FALSE,4013932,2341,741,1600,1541
dauds,FALSE,4013351,2354,685,1669,1519.5
fixed,FALSE,4013258,2317,786,1531,1551.5
ammon,FALSE,4012881.5,2430,502,1928,1466
taboo,TRUE,4012763,2516,700,1816,1608
looms,FALSE,4012418,2237,715,1522,1476
lossy,FALSE,4012069.5,2356,982,1374,1669
ahull,FALSE,4011857,2393,768,1625,1580.5
gests,FALSE,4011666,2641,612,2029,1626.5
bovid,FALSE,4011548,2106,777,1329,1441.5
newel,FALSE,4011485,2448,779,1669,1613.5
tiyin,FALSE,4011456,2281,668,1613,1474.5
junco,FALSE,4011451,2155,555,1600,1355
ducks,FALSE,4010888,2095,444,1651,1269.5
squid,FALSE,4010522,2121,812,1309,1466.5
vifda,FALSE,4009837,2282,403,1879,1342.5
lymph,TRUE,4008725,2088,361,1727,1224.5
marah,FALSE,4008401,2423,876,1547,1649.5
gawks,FALSE,4008200,2223,536,1687,1379.5
defer,TRUE,4007835,2470,908,1562,1689
enema,TRUE,4007799.5,2813,468,2345,1640.5
nduja,FALSE,4007627,2313,288,2025,1300.5
thumb,TRUE,4007606,2068,537,1531,1302.5
didos,FALSE,4006846,2308,556,1752,1432
boron,FALSE,4006678,2327,877,1450,1602
damar,FALSE,4006354,2414,851,1563,1632.5
jowed,FALSE,4006324,2320,761,1559,1540.5
omasa,FALSE,4005841,2498,621,1877,1559.5
snabs,FALSE,4005201,2344,820,1524,1582
swell,TRUE,4004784,2516,905,1611,1710.5
baisa,FALSE,4004534,2441,978,1463,1709.5
disas,FALSE,4003928,2544,592,1952,1568
mawks,FALSE,4003928,2221,528,1693,1374.5
modem,TRUE,4002943.5,2397,821,1576,1609
glede,FALSE,4002889.5,2374,986,1388,1680
rekey,FALSE,4002754,2512,1041,1471,1776.5
kopje,FALSE,4002734,2304,783,1521,1543.5
suhur,FALSE,4002319,2291,855,1436,1573
linny,FALSE,4002102.5,2262,975,1287,1618.5
balls,FALSE,4002001,2442,787,1655,1614.5
boots,FALSE,4001902,2225,871,1354,1548
staws,FALSE,4001867,2388,811,1577,1599.5
shays,FALSE,4001814,2323,856,1467,1589.5
oohed,FALSE,4001739,2478,765,1713,1621.5
pogge,FALSE,4001663.5,2375,988,1387,1681.5
bobac,FALSE,4001147,2297,703,1594,1500
mirin,FALSE,4000791,2332,760,1572,1546
chimb,FALSE,4000380,2039,687,1352,1363
ishes,FALSE,4000379,2700,413,2287,1556.5
aboon,FALSE,3999841,2399,663,1736,1531
skrik,FALSE,3999723.5,2304,810,1494,1557
deely,FALSE,3999188.5,2491,1056,1435,1773.5
biali,FALSE,3999020,2471,855,1616,1663
kulfi,FALSE,3998794,2161,364,1797,1262.5
wocks,FALSE,3998656,2135,509,1626,1322
bundh,FALSE,3997992,2023,706,1317,1364.5
zoaea,FALSE,3997810,2673,971,1702,1822
kufis,FALSE,3997040,2131,425,1706,1278
skank,FALSE,3996911.5,2279,978,1301,1628.5
cycas,FALSE,3996647,2392,476,1916,1434
soldo,FALSE,3996451,2309,884,1425,1596.5
beery,FALSE,3996125.5,2577,1108,1469,1842.5
where,TRUE,3996109.5,2466,980,1486,1723
jongs,FALSE,3996009,2168,550,1618,1359
hohed,FALSE,3995662,2478,793,1685,1635.5
bunks,FALSE,3995078,2094,589,1505,1341.5
hanch,FALSE,3994227,2286,803,1483,1544.5
evite,FALSE,3993694,2519,916,1603,1717.5
bubal,FALSE,3993292,2281,735,1546,1508
smoot,FALSE,3993199,2256,1033,1223,1644.5
delly,FALSE,3992900,2491,991,1500,1741
kurre,FALSE,3992760,2552,945,1607,1748.5
ordos,FALSE,3992639,2498,551,1947,1524.5
husky,TRUE,3992101,2073,754,1319,1413.5
bawdy,TRUE,3992071,2157,936,1221,1546.5
holon,FALSE,3992034,2250,722,1528,1486
manas,FALSE,3991926,2375,749,1626,1562
union,TRUE,3991876.5,2327,648,1679,1487.5
polos,FALSE,3991490,2285,701,1584,1493
truth,TRUE,3991160,2340,859,1481,1599.5
illth,FALSE,3990622.5,2341,625,1716,1483
temed,FALSE,3990251,2391,888,1503,1639.5
smash,TRUE,3989604.5,2204,1021,1183,1612.5
jubas,FALSE,3989564,2278,462,1816,1370
hewer,FALSE,3989506,2466,867,1599,1666.5
fyked,FALSE,3989220,2252,607,1645,1429.5
ortho,FALSE,3989174,2556,505,2051,1530.5
kerky,FALSE,3988573.5,2512,844,1668,1678
bools,FALSE,3988242,2206,894,1312,1550
alibi,TRUE,3988011,2471,643,1828,1557
flunk,TRUE,3987970,2064,797,1267,1430.5
mimed,FALSE,3987515,2371,806,1565,1588.5
banns,FALSE,3987512.5,2344,834,1510,1589
wirra,FALSE,3987217,2587,664,1923,1625.5
praam,FALSE,3987185,2390,921,1469,1655.5
apian,FALSE,3987176,2452,761,1691,1606.5
haram,FALSE,3986746,2423,741,1682,1582
wacky,TRUE,3986698,2170,862,1308,1516
tween,FALSE,3986443.5,2467,818,1649,1642.5
veles,FALSE,3986182,2471,751,1720,1611
nabob,FALSE,3986009,2399,541,1858,1470
quods,FALSE,3985803,2147,558,1589,1352.5
batts,FALSE,3985466,2461,763,1698,1612
dusky,TRUE,3985366,2064,796,1268,1430
umphs,FALSE,3985292,2098,193,1905,1145.5
henny,FALSE,3985146.5,2402,996,1406,1699
egest,FALSE,3985025.5,2641,685,1956,1663
picky,TRUE,3983365,2060,819,1241,1439.5
quipo,FALSE,3983296,2152,583,1569,1367.5
bises,FALSE,3983143,2588,809,1779,1698.5
slush,TRUE,3983139.5,2102,1042,1060,1572
emule,FALSE,3982980,2459,861,1598,1660
coopt,FALSE,3982466,2134,1024,1110,1579
phene,FALSE,3982184.5,2331,1069,1262,1700
polio,FALSE,3981754,2314,749,1565,1531.5
baloo,FALSE,3980905,2497,779,1718,1638
spill,TRUE,3980824,2259,1011,1248,1635
meted,FALSE,3980765,2391,896,1495,1643.5
labia,FALSE,3980471,2471,671,1800,1571
slogs,FALSE,3979983,2239,923,1316,1581
aargh,FALSE,3979646,2425,823,1602,1624
missa,FALSE,3979546.5,2472,624,1848,1548
nyssa,FALSE,3979216.5,2494,375,2119,1434.5
peeoy,FALSE,3978561.5,2492,1057,1435,1774.5
awato,FALSE,3978491,2443,689,1754,1566
veena,FALSE,3978235.5,2664,708,1956,1686
ceaze,FALSE,3977839,2448,1191,1257,1819.5
gaffe,TRUE,3977209,2472,903,1569,1687.5
sikas,FALSE,3976498,2376,779,1597,1577.5
frill,TRUE,3976475,2339,987,1352,1663
nemns,FALSE,3976312.5,2522,558,1964,1540
leves,FALSE,3975772,2471,733,1738,1602
musse,FALSE,3975310.5,2429,968,1461,1698.5
amiss,TRUE,3975231.5,2472,652,1820,1562
aging,TRUE,3974332.5,2406,642,1764,1524
goory,FALSE,3974257,2227,1154,1073,1690.5
ennog,FALSE,3974179,2579,471,2108,1525
flaxy,FALSE,3974089,2218,1011,1207,1614.5
seedy,TRUE,3973238.5,2461,1218,1243,1839.5
pucks,FALSE,3972731,2071,475,1596,1273
sheep,TRUE,3972697.5,2399,1061,1338,1730
varan,FALSE,3972436,2445,803,1642,1624
chivy,FALSE,3972272,2040,1018,1022,1529
hillo,FALSE,3972207,2347,603,1744,1475
tikka,FALSE,3972181.5,2425,482,1943,1453.5
sheds,FALSE,3971744,2423,792,1631,1607.5
allee,FALSE,3971707.5,2613,1196,1417,1904.5
shoon,FALSE,3971229,2220,1016,1204,1618
wimps,FALSE,3971068,2103,432,1671,1267.5
quayd,FALSE,3970906,2182,637,1545,1409.5
pedes,FALSE,3970659,2390,813,1577,1601.5
booay,FALSE,3970006,2266,1223,1043,1744.5
moory,FALSE,3969985,2225,1146,1079,1685.5
rarks,FALSE,3969900,2566,663,1903,1614.5
comfy,TRUE,3969565,2043,937,1106,1490
admix,FALSE,3969491,2261,388,1873,1324.5
whack,TRUE,3969430,2132,799,1333,1465.5
ditzy,FALSE,3969275,2136,808,1328,1472
hodad,FALSE,3969156.5,2331,704,1627,1517.5
zincy,FALSE,3969027,2097,860,1237,1478.5
chawk,FALSE,3968950,2132,787,1345,1459.5
zings,FALSE,3968083,2150,456,1694,1303
bassi,FALSE,3968067.5,2441,739,1702,1590
yeesh,FALSE,3967302.5,2470,735,1735,1602.5
varia,FALSE,3966429,2542,732,1810,1637
berry,TRUE,3965638,2577,1094,1483,1835.5
asyla,FALSE,3965554,2592,412,2180,1502
surds,FALSE,3965533,2282,820,1462,1551
tuffe,FALSE,3965370,2387,819,1568,1603
napoo,FALSE,3965288,2478,589,1889,1533.5
kneel,TRUE,3965086.5,2456,758,1698,1607
midgy,FALSE,3964646,2032,824,1208,1428
whilk,FALSE,3964644,2070,768,1302,1419
neele,FALSE,3964638.5,2254,1042,1212,1648
epode,FALSE,3964620,2445,870,1575,1657.5
shins,FALSE,3964506,2194,994,1200,1594
balsa,FALSE,3964240,2442,824,1618,1633
rishi,FALSE,3963430,2481,426,2055,1453.5
thebe,FALSE,3963262.5,2369,918,1451,1643.5
basta,FALSE,3963203,2461,760,1701,1610.5
ooped,FALSE,3962643,2445,814,1631,1629.5
skeen,FALSE,3961695.5,2426,1001,1425,1713.5
tanga,FALSE,3961532,2426,732,1694,1579
vying,TRUE,3961207,2063,555,1508,1309
knubs,FALSE,3961129,2094,332,1762,1213
krill,TRUE,3960929,2334,871,1463,1602.5
costs,FALSE,3960307,2406,732,1674,1569
sloom,FALSE,3960176,2237,985,1252,1611
navar,FALSE,3959797,2445,765,1680,1605
marry,TRUE,3959545,2461,1090,1371,1775.5
chirr,FALSE,3958201,2311,972,1339,1641.5
erven,FALSE,3958049,2592,836,1756,1714
manta,FALSE,3957721,2424,753,1671,1588.5
obiit,FALSE,3957590,2254,734,1520,1494
comix,FALSE,3957407,2103,704,1399,1403.5
neems,FALSE,3957218.5,2522,560,1962,1541
dumbo,FALSE,3956818,2065,440,1625,1252.5
quids,FALSE,3956603,2121,580,1541,1350.5
arval,FALSE,3956503,2543,776,1767,1659.5
limit,TRUE,3955967,2260,762,1498,1511
feels,FALSE,3955741.5,2529,753,1776,1641
speed,TRUE,3955644.5,2390,1040,1350,1715
azyms,FALSE,3955330,2277,276,2001,1276.5
volva,FALSE,3954424,2379,544,1835,1461.5
iring,FALSE,3954107,2334,790,1544,1562
keets,FALSE,3953855.5,2543,614,1929,1578.5
henge,FALSE,3953492,2285,950,1335,1617.5
refed,FALSE,3953182,2470,808,1662,1639
basan,FALSE,3953060,2344,850,1494,1597
nieve,FALSE,3952921.5,2402,886,1516,1644
vaded,FALSE,3952832.5,2484,858,1626,1671
wicks,FALSE,3952750,2109,432,1677,1270.5
nagas,FALSE,3952386,2377,607,1770,1492
untin,FALSE,3952246.5,2321,519,1802,1420
pupas,FALSE,3952071,2330,585,1745,1457.5
noops,FALSE,3952021,2187,646,1541,1416.5
oribi,FALSE,3951860,2424,609,1815,1516.5
heigh,FALSE,3951524,2382,792,1590,1587
freed,TRUE,3951295.5,2470,1016,1454,1743
tawai,FALSE,3951278,2417,653,1764,1535
tipis,FALSE,3951064,2278,603,1675,1440.5
butte,TRUE,3950778,2447,1033,1414,1740
kamme,FALSE,3950638.5,2465,877,1588,1671
seize,TRUE,3950575,2356,1318,1038,1837
agloo,FALSE,3950151,2530,455,2075,1492.5
pauas,FALSE,3950072,2330,810,1520,1570
alvar,FALSE,3949908,2543,766,1777,1654.5
shads,FALSE,3949525,2276,922,1354,1599
fells,FALSE,3949453,2529,688,1841,1608.5
judos,FALSE,3949379,2145,449,1696,1297
bests,FALSE,3948969,2608,670,1938,1639
ditto,TRUE,3948937,2357,621,1736,1489
babus,FALSE,3948688,2251,652,1599,1451.5
endue,FALSE,3948462,2433,740,1693,1586.5
apsos,FALSE,3948270,2546,450,2096,1498
takas,FALSE,3948048,2396,664,1732,1530
unjam,FALSE,3947447,2241,328,1913,1284.5
bilbo,FALSE,3947300,2235,569,1666,1402
gasts,FALSE,3947148,2494,674,1820,1584
blobs,FALSE,3946733,2206,678,1528,1442
offal,TRUE,3946700,2437,393,2044,1415
nouns,FALSE,3946575.5,2298,699,1599,1498.5
zizel,FALSE,3946462,2386,690,1696,1538
bemix,FALSE,3946069,2305,642,1663,1473.5
slims,FALSE,3945965,2211,937,1274,1574
leggy,TRUE,3945703.5,2421,837,1584,1629
bawks,FALSE,3945503,2190,594,1596,1392
tinty,FALSE,3945217,2281,993,1288,1637
gemma,FALSE,3945127.5,2563,550,2013,1556.5
laddy,FALSE,3944987,2344,900,1444,1622
genii,FALSE,3944948,2553,665,1888,1609
weets,FALSE,3944076.5,2535,677,1858,1606
plumb,TRUE,3943929,2016,587,1429,1301.5
amias,FALSE,3943811,2472,644,1828,1558
lemed,FALSE,3943349,2372,827,1545,1599.5
koala,TRUE,3943140,2432,832,1600,1632
seven,TRUE,3942906,2373,1105,1268,1739
masts,FALSE,3942876,2492,666,1826,1579
smits,FALSE,3942750,2230,845,1385,1537.5
algas,FALSE,3942497,2475,608,1867,1541.5
amaut,FALSE,3941833,2331,821,1510,1576
boded,FALSE,3941636.5,2366,963,1403,1664.5
mania,TRUE,3941571,2404,772,1632,1588
bhaji,FALSE,3941548,2229,637,1592,1433
aigas,FALSE,3941520,2474,609,1865,1541.5
quops,FALSE,3941458,2123,539,1584,1331
reked,FALSE,3941382,2465,795,1670,1630
kakis,FALSE,3941271,2376,530,1846,1453
dolls,FALSE,3940340,2309,700,1609,1504.5
penny,TRUE,3940254.5,2369,1069,1300,1719
keels,FALSE,3940195.5,2524,637,1887,1580.5
yills,FALSE,3939967,2330,518,1812,1424
ozzie,FALSE,3939958,2411,636,1775,1523.5
snods,FALSE,3939846,2211,802,1409,1506.5
larva,TRUE,3939647,2543,665,1878,1604
aggry,FALSE,3939215.5,2463,736,1727,1599.5
snood,FALSE,3938712,2211,947,1264,1579
areae,FALSE,3938533.5,2802,1172,1630,1987
lysol,FALSE,3938306,2356,479,1877,1417.5
petty,TRUE,3938208,2486,998,1488,1742
paspy,FALSE,3937947,2290,940,1350,1615
roomy,TRUE,3937928,2225,1060,1165,1642.5
almas,FALSE,3937909,2473,602,1871,1537.5
bebop,FALSE,3937644,2342,660,1682,1501
kokas,FALSE,3937483,2402,510,1892,1456
howdy,TRUE,3937145,2033,807,1226,1420
pened,FALSE,3936451,2322,959,1363,1640.5
chess,TRUE,3935988.5,2501,726,1775,1613.5
hijab,FALSE,3935352,2229,448,1781,1338.5
fugly,FALSE,3935341,2029,915,1114,1472
hooty,FALSE,3935018,2136,1095,1041,1615.5
tawas,FALSE,3934784,2388,678,1710,1533
palay,FALSE,3934094,2320,1085,1235,1702.5
lavra,FALSE,3934067,2543,657,1886,1600
katas,FALSE,3933942,2396,634,1762,1515
kells,FALSE,3933907,2524,572,1952,1548
perve,FALSE,3933617,2388,1017,1371,1702.5
jivey,FALSE,3933582,2296,953,1343,1624.5
kojis,FALSE,3933462,2167,496,1671,1331.5
skyey,FALSE,3933146,2293,1087,1206,1690
tomos,FALSE,3932921,2256,657,1599,1456.5
fetts,FALSE,3932918,2548,664,1884,1606
spays,FALSE,3932889,2290,773,1517,1531.5
edger,FALSE,3932136,2563,689,1874,1626
cleck,FALSE,3931458,2354,841,1513,1597.5
whisk,TRUE,3930879,2040,777,1263,1408.5
neese,FALSE,3930873.5,2224,1051,1173,1637.5
inbox,TRUE,3930851,2174,318,1856,1246
breem,FALSE,3930793.5,2458,977,1481,1717.5
wooed,FALSE,3930779,2293,1042,1251,1667.5
gulag,FALSE,3930726,2314,617,1697,1465.5
feyly,FALSE,3930686,2328,933,1395,1630.5
weels,FALSE,3930416.5,2516,700,1816,1608
briss,FALSE,3930297.5,2369,913,1456,1641
skens,FALSE,3930213,2426,771,1655,1598.5
druxy,FALSE,3930107,2118,910,1208,1514
girrs,FALSE,3929869,2402,668,1734,1535
goons,FALSE,3929717,2141,856,1285,1498.5
sakai,FALSE,3929122,2376,856,1520,1616
seepy,FALSE,3928893.5,2437,1199,1238,1818
dally,TRUE,3928382,2344,1053,1291,1698.5
chico,FALSE,3928287,2147,818,1329,1482.5
apsis,FALSE,3928250,2520,476,2044,1498
hunky,TRUE,3928194,2005,813,1192,1409
allow,TRUE,3928175.5,2424,603,1821,1513.5
heuch,FALSE,3928152,2340,767,1573,1553.5
rewed,FALSE,3928118,2457,809,1648,1633
taggy,FALSE,3928087.5,2293,960,1333,1626.5
pilis,FALSE,3927178,2259,650,1609,1454.5
barca,FALSE,3927165,2461,856,1605,1658.5
pigmy,FALSE,3926903,2008,843,1165,1425.5
hadal,FALSE,3926723,2306,767,1539,1536.5
occur,TRUE,3926516,2415,431,1984,1423
capas,FALSE,3926438,2321,759,1562,1540
undue,TRUE,3926408,2433,701,1732,1567
sanga,FALSE,3926112,2377,949,1428,1663
malmy,FALSE,3926077.5,2272,955,1317,1613.5
jauks,FALSE,3925785,2213,580,1633,1396.5
moons,FALSE,3925445,2139,848,1291,1493.5
bombe,FALSE,3925217,2294,961,1333,1627.5
sigil,FALSE,3925047,2213,949,1264,1581
fundy,FALSE,3924580,2001,894,1107,1447.5
quirk,TRUE,3924575,2172,740,1432,1456
going,TRUE,3924574,2170,883,1287,1526.5
wells,FALSE,3924128,2516,635,1881,1575.5
nevel,FALSE,3923277,2403,802,1601,1602.5
juves,FALSE,3922948,2307,609,1698,1458
bungy,FALSE,3922751,1991,938,1053,1464.5
beted,FALSE,3922340,2360,962,1398,1661
judge,TRUE,3922199,2210,781,1429,1495.5
spasm,TRUE,3922031.5,2171,947,1224,1559
doyly,FALSE,3921573,2108,945,1163,1526.5
jowls,FALSE,3921396,2160,523,1637,1341.5
hooly,FALSE,3921358,2117,1118,999,1617.5
elemi,FALSE,3920889.5,2649,529,2120,1589
stims,FALSE,3920548,2230,813,1417,1521.5
currs,FALSE,3920436,2360,735,1625,1547.5
accoy,FALSE,3919674,2447,733,1714,1590
tondo,FALSE,3919502,2260,694,1566,1477
sinhs,FALSE,3919191,2194,771,1423,1482.5
muxed,FALSE,3919175,2218,741,1477,1479.5
fanon,FALSE,3918960.5,2339,841,1498,1590
squaw,FALSE,3918813,2207,716,1491,1461.5
psoas,FALSE,3918715,2546,601,1945,1573.5
gulfy,FALSE,3918669,2029,812,1217,1420.5
murra,FALSE,3918459,2501,672,1829,1586.5
koros,FALSE,3918414,2330,630,1700,1480
evert,FALSE,3917836.5,2709,669,2040,1689
hefte,FALSE,3917603,2309,899,1410,1604
dyads,FALSE,3917487,2314,546,1768,1430
gimpy,FALSE,3917216,2008,792,1216,1400
rexes,FALSE,3917174,2548,713,1835,1630.5
runny,FALSE,3916978.5,2261,976,1285,1618.5
sinds,FALSE,3916038,2185,812,1373,1498.5
spurs,FALSE,3915805,2258,780,1478,1519
scags,FALSE,3915782,2275,825,1450,1550
leeks,FALSE,3915188.5,2524,598,1926,1561
rutty,FALSE,3914932,2378,905,1473,1641.5
dooly,FALSE,3914623,2108,1160,948,1634
casus,FALSE,3914537,2432,700,1732,1566
cists,FALSE,3914401,2380,655,1725,1517.5
beige,FALSE,3914099,2270,1181,1089,1725.5
chott,FALSE,3913992,2167,978,1189,1572.5
danny,FALSE,3913893.5,2246,1100,1146,1673
sybbe,FALSE,3913132,2358,894,1464,1626
debel,FALSE,3913097,2341,884,1457,1612.5
rezes,FALSE,3912652,2546,712,1834,1629
atmas,FALSE,3912492,2492,478,2014,1485
quips,FALSE,3912258,2097,561,1536,1329
ridic,FALSE,3912054,2302,571,1731,1436.5
gleed,FALSE,3911845.5,2374,929,1445,1651.5
vampy,FALSE,3911621,2119,822,1297,1470.5
pacas,FALSE,3911154,2321,701,1620,1511
slobs,FALSE,3911107,2206,871,1335,1538.5
scams,FALSE,3910964,2273,817,1456,1545
bedel,FALSE,3910765,2341,964,1377,1652.5
tammy,FALSE,3909856.5,2291,946,1345,1618.5
tafia,FALSE,3909493,2430,700,1730,1565
clack,TRUE,3909239,2207,971,1236,1589
wonky,FALSE,3909227,2036,920,1116,1478
molto,FALSE,3909165,2286,695,1591,1490.5
vichy,FALSE,3909076,2040,693,1347,1366.5
pyxed,FALSE,3908930,2226,613,1613,1419.5
vivas,FALSE,3908897,2323,493,1830,1408
kimbo,FALSE,3908459,2087,365,1722,1226
logoi,FALSE,3907101,2268,577,1691,1422.5
nitid,FALSE,3907039,2234,626,1608,1430
agita,FALSE,3906616,2523,622,1901,1572.5
gumps,FALSE,3906582,2019,448,1571,1233.5
bubas,FALSE,3906022,2251,615,1636,1433
deere,FALSE,3905564.5,2263,1106,1157,1684.5
khuds,FALSE,3905453,2026,434,1592,1230
shaps,FALSE,3905180,2252,903,1349,1577.5
lurry,FALSE,3905076,2359,953,1406,1656
zacks,FALSE,3904847,2212,454,1758,1333
fence,TRUE,3904254,2261,1093,1168,1677
fanal,FALSE,3903705,2314,898,1416,1606
amlas,FALSE,3903517,2473,490,1983,1481.5
spoon,TRUE,3902304,2187,933,1254,1560
polls,FALSE,3902183,2285,731,1554,1508
scuts,FALSE,3901284,2190,746,1444,1468
fjeld,FALSE,3901259,2308,595,1713,1451.5
hills,FALSE,3901169,2292,581,1711,1436.5
barry,FALSE,3901120,2430,1156,1274,1793
avast,FALSE,3900958,2343,887,1456,1615
tempt,FALSE,3900869,2367,755,1612,1561
plebe,FALSE,3899585.5,2317,968,1349,1642.5
khoum,FALSE,3899466,2009,532,1477,1270.5
howfs,FALSE,3898042,2071,445,1626,1258
swans,FALSE,3897322,2271,935,1336,1603
yechy,FALSE,3897053,2300,696,1604,1498
unpen,FALSE,3897022.5,2409,626,1783,1517.5
bucko,FALSE,3896605,2047,528,1519,1287.5
koses,FALSE,3896437,2549,733,1816,1641
ahigh,FALSE,3896424,2235,766,1469,1500.5
enzym,FALSE,3895973,2356,215,2141,1285.5
bided,FALSE,3895730.5,2340,886,1454,1613
spins,FALSE,3895581,2161,911,1250,1536
micky,FALSE,3894626,2012,784,1228,1398
dills,FALSE,3894434,2283,623,1660,1453
hafiz,FALSE,3894396,2177,560,1617,1368.5
jirre,FALSE,3893784,2567,961,1606,1764
comma,TRUE,3893768.5,2328,670,1658,1499
draff,FALSE,3893741,2323,746,1577,1534.5
preve,FALSE,3893622.5,2388,1056,1332,1722
wuxia,FALSE,3893377,2244,503,1741,1373.5
odour,FALSE,3893198,2337,599,1738,1468
drama,TRUE,3893115,2414,817,1597,1615.5
animi,FALSE,3893037,2404,573,1831,1488.5
agila,FALSE,3892956,2504,645,1859,1574.5
saggy,FALSE,3892667.5,2244,1177,1067,1710.5
sappy,TRUE,3892177,2290,1142,1148,1716
caboc,FALSE,3891644.5,2297,722,1575,1509.5
coxib,FALSE,3891584,2072,658,1414,1365
ingan,FALSE,3891559.5,2406,481,1925,1443.5
gugas,FALSE,3891363,2284,567,1717,1425.5
hokum,FALSE,3890906,2009,484,1525,1246.5
nihil,FALSE,3890763,2224,562,1662,1393
logos,FALSE,3890607,2239,602,1637,1420.5
howks,FALSE,3890577,2066,465,1601,1265.5
pinon,FALSE,3890302.5,2216,745,1471,1480.5
pally,FALSE,3890225,2320,1084,1236,1702
kirks,FALSE,3890107.5,2304,476,1828,1390
ionic,TRUE,3890044,2318,641,1677,1479.5
keeno,FALSE,3890011.5,2481,679,1802,1580
ousts,FALSE,3889889,2415,482,1933,1448.5
poupt,FALSE,3889665,2143,889,1254,1516
blurb,TRUE,3889457,2209,702,1507,1455.5
hemes,FALSE,3889299,2351,726,1625,1538.5
apeek,FALSE,3888505.5,2513,810,1703,1661.5
skivy,FALSE,3888496,2033,1052,981,1542.5
lusts,FALSE,3888407,2390,529,1861,1459.5
gucks,FALSE,3888264,2025,448,1577,1236.5
twats,FALSE,3888134,2388,675,1713,1531.5
sculs,FALSE,3887624,2171,769,1402,1470
knell,FALSE,3887229,2456,602,1854,1529
jacks,FALSE,3886867,2204,471,1733,1337.5
bufty,FALSE,3886862,2015,887,1128,1451
snoop,TRUE,3886840,2187,885,1302,1536
chocs,FALSE,3886449,2118,774,1344,1446
dumbs,FALSE,3885780,2010,418,1592,1214
stobs,FALSE,3885690,2225,747,1478,1486
potts,FALSE,3885648,2304,707,1597,1505.5
avail,TRUE,3885243,2353,777,1576,1565
qubit,FALSE,3885146,2067,677,1390,1372
yeeds,FALSE,3885132.5,2461,530,1931,1495.5
tawts,FALSE,3885008,2388,654,1734,1521
dandy,TRUE,3885004,2246,987,1259,1616.5
falls,FALSE,3884935,2382,750,1632,1566
foots,FALSE,3884836,2165,834,1331,1499.5
fifed,FALSE,3884738,2280,799,1481,1539.5
azuki,FALSE,3884597,2250,374,1876,1312
basts,FALSE,3884451,2461,732,1729,1596.5
hakea,FALSE,3884159,2546,767,1779,1656.5
mucks,FALSE,3883992,2023,440,1583,1231.5
kreep,FALSE,3883877.5,2441,838,1603,1639.5
punky,FALSE,3883302,1972,886,1086,1429
bania,FALSE,3883146,2373,838,1535,1605.5
ponzu,FALSE,3882775,2061,581,1480,1321
india,FALSE,3882770,2476,418,2058,1447
demes,FALSE,3882564,2342,768,1574,1555
kroon,FALSE,3882409,2262,793,1469,1527.5
cabob,FALSE,3882194,2297,702,1595,1499.5
nonyl,FALSE,3881473,2288,614,1674,1451
albas,FALSE,3881172,2442,598,1844,1520
usury,FALSE,3881009,2329,730,1599,1529.5
kiack,FALSE,3880986.5,2206,794,1412,1500
laika,FALSE,3880680,2406,777,1629,1591.5
hotch,FALSE,3880298,2167,750,1417,1458.5
mikva,FALSE,3879301,2205,431,1774,1318
phlox,FALSE,3879070,2083,538,1545,1310.5
seise,FALSE,3878183.5,2321,1469,852,1895
funks,FALSE,3878012,2034,552,1482,1293
ditts,FALSE,3877899,2302,599,1703,1450.5
knees,FALSE,3877816.5,2426,638,1788,1532
pacta,FALSE,3876949,2370,705,1665,1537.5
ewers,FALSE,3876906.5,2705,481,2224,1593
hoove,FALSE,3876596,2257,1062,1195,1659.5
gauzy,FALSE,3875893,2118,968,1150,1543
crock,TRUE,3875326,2160,974,1186,1567
eches,FALSE,3875297,2501,475,2026,1488
cabal,TRUE,3874516,2272,878,1394,1575
sammy,FALSE,3874436.5,2242,1163,1079,1702.5
skirr,FALSE,3874425,2304,1006,1298,1655
adapt,TRUE,3873755,2292,771,1521,1531.5
patty,TRUE,3873690,2339,1060,1279,1699.5
wombs,FALSE,3873548,2050,483,1567,1266.5
droop,TRUE,3872506,2226,810,1416,1518
jived,FALSE,3872210,2249,707,1542,1478
kiosk,TRUE,3871635.5,2140,750,1390,1445
mauzy,FALSE,3871621,2116,960,1156,1538
fools,FALSE,3871176,2146,857,1289,1501.5
nancy,FALSE,3870945,2324,996,1328,1660
ivies,FALSE,3870616,2470,669,1801,1569.5
reede,FALSE,3870324.5,2263,1017,1246,1640
oobit,FALSE,3870293,2254,788,1466,1521
gelly,FALSE,3870276,2421,995,1426,1708
neddy,FALSE,3869740,2393,787,1606,1590
katti,FALSE,3869348,2425,585,1840,1505
yeggs,FALSE,3869079.5,2391,427,1964,1409
nymph,TRUE,3868960,1990,310,1680,1150
slomo,FALSE,3868568,2237,937,1300,1587
basis,TRUE,3868301,2441,751,1690,1596
snaws,FALSE,3868252,2271,821,1450,1546
atman,FALSE,3868144,2424,572,1852,1498
birrs,FALSE,3867172,2369,726,1643,1547.5
boons,FALSE,3867020,2108,914,1194,1511
shyly,TRUE,3866744,2062,1065,997,1563.5
snips,FALSE,3866301,2161,805,1356,1483
nulls,FALSE,3866192,2273,533,1740,1403
risps,FALSE,3865897,2448,473,1975,1460.5
frorn,FALSE,3865598,2267,929,1338,1598
jougs,FALSE,3865416,2075,576,1499,1325.5
iroko,FALSE,3865046,2359,658,1701,1508.5
chump,TRUE,3865006,1928,631,1297,1279.5
pekoe,FALSE,3864781,2277,952,1325,1614.5
hevea,FALSE,3863846,2493,742,1751,1617.5
wowed,FALSE,3863478.5,2293,824,1469,1558.5
lammy,FALSE,3862954.5,2272,885,1387,1578.5
sakia,FALSE,3862273,2376,904,1472,1640
jupon,FALSE,3861234,2053,526,1527,1289.5
kauru,FALSE,3861049,2405,642,1763,1523.5
ayahs,FALSE,3860871,2323,535,1788,1429
imide,FALSE,3860823,2371,831,1540,1601
puses,FALSE,3860733,2477,762,1715,1619.5
nitty,FALSE,3860291,2281,853,1428,1567
lipin,FALSE,3859814,2191,636,1555,1413.5
walls,FALSE,3859610,2369,697,1672,1533
cleek,FALSE,3859483.5,2354,1007,1347,1680.5
mitis,FALSE,3859123,2230,614,1616,1422
musky,TRUE,3858470,1992,792,1200,1392
gayal,FALSE,3858307,2274,767,1507,1520.5
tepee,TRUE,3858196,2069,1191,878,1630
calpa,FALSE,3857969,2351,728,1623,1539.5
chics,FALSE,3857249,2092,796,1296,1444
hashy,FALSE,3856504,2323,845,1478,1584
pills,FALSE,3856277,2259,654,1605,1456.5
genny,FALSE,3855787.5,2323,1042,1281,1682.5
myoma,FALSE,3855501.5,2297,506,1791,1401.5
ogeed,FALSE,3854941.5,2399,666,1733,1532.5
gimme,FALSE,3853059.5,2301,870,1431,1585.5
curch,FALSE,3852989,2121,838,1283,1479.5
darga,FALSE,3852602,2416,718,1698,1567
poulp,FALSE,3852002,2124,804,1320,1464
lazar,FALSE,3851992,2429,778,1651,1603.5
scull,FALSE,3851645,2171,889,1282,1530
apaid,FALSE,3851576,2272,785,1487,1528.5
whups,FALSE,3851329,1994,478,1516,1236
zambo,FALSE,3850777,2182,450,1732,1316
yarak,FALSE,3850609,2365,749,1616,1557
boord,FALSE,3850188,2147,966,1181,1556.5
telex,FALSE,3850108,2408,829,1579,1618.5
cleve,FALSE,3850083.5,2301,1046,1255,1673.5
kanzu,FALSE,3849981,2153,484,1669,1318.5
fossa,FALSE,3849961.5,2407,730,1677,1568.5
conch,TRUE,3849400,2050,907,1143,1478.5
dayan,FALSE,3849313,2246,737,1509,1491.5
bleed,TRUE,3849148.5,2341,987,1354,1664
vasal,FALSE,3848892,2324,746,1578,1535
garda,FALSE,3848873,2416,715,1701,1565.5
ferry,TRUE,3848572,2517,1057,1460,1787
bulky,TRUE,3848507,1991,890,1101,1440.5
coops,FALSE,3848206,2085,807,1278,1446
reefy,FALSE,3848163.5,2517,923,1594,1720
apply,TRUE,3847929.5,2320,786,1534,1553
mened,FALSE,3847712,2274,924,1350,1599
varna,FALSE,3847697,2445,756,1689,1600.5
flitt,FALSE,3847367,2169,995,1174,1582
gemel,FALSE,3847210,2302,892,1410,1597
scabs,FALSE,3846906,2242,773,1469,1507.5
tavas,FALSE,3846576,2343,701,1642,1522
heeds,FALSE,3846334.5,2423,593,1830,1508
logon,FALSE,3846259,2171,696,1475,1433.5
crick,TRUE,3846126,2134,996,1138,1565
boxty,FALSE,3846022,2061,967,1094,1514
wools,FALSE,3845851,2133,804,1329,1468.5
gongs,FALSE,3845550.5,2141,645,1496,1393
myall,FALSE,3845544,2272,755,1517,1513.5
umami,FALSE,3845112,2311,457,1854,1384
bacco,FALSE,3845108,2297,743,1554,1520
kopek,FALSE,3844782.5,2277,788,1489,1532.5
venin,FALSE,3844738.5,2402,712,1690,1557
verge,TRUE,3844719,2342,948,1394,1645
riffs,FALSE,3844718,2309,403,1906,1356
imaum,FALSE,3844607,2311,503,1808,1407
bolos,FALSE,3844326,2206,732,1474,1469
appui,FALSE,3844271.5,2359,353,2006,1356
camas,FALSE,3843983,2273,762,1511,1517.5
bumps,FALSE,3843885,1986,506,1480,1246
evade,TRUE,3843831,2484,887,1597,1685.5
libri,FALSE,3843614,2399,510,1889,1454.5
gadid,FALSE,3843585.5,2226,770,1456,1498
nabla,FALSE,3843196,2374,624,1750,1499
watts,FALSE,3843075,2388,673,1715,1530.5
songs,FALSE,3843049,2141,896,1245,1518.5
arroz,FALSE,3841109,2454,707,1747,1580.5
wises,FALSE,3840752,2515,719,1796,1617
reeky,FALSE,3840698.5,2512,943,1569,1727.5
fubsy,FALSE,3840251,1966,914,1052,1440
shaya,FALSE,3840004,2323,884,1439,1603.5
aspis,FALSE,3839857,2520,409,2111,1464.5
madid,FALSE,3839313.5,2224,762,1462,1493
zurfs,FALSE,3838430,2154,423,1731,1288.5
pujah,FALSE,3838358,2118,633,1485,1375.5
loofs,FALSE,3838088,2146,682,1464,1414
yowza,FALSE,3837000,2228,395,1833,1311.5
subas,FALSE,3836604,2251,808,1443,1529.5
adays,FALSE,3836129,2314,507,1807,1410.5
beget,TRUE,3836091,2290,1053,1237,1671.5
dowed,FALSE,3836034.5,2293,852,1441,1572.5
neves,FALSE,3836007,2373,682,1691,1527.5
feens,FALSE,3834519.5,2431,773,1658,1602
hitch,TRUE,3834392,2141,673,1468,1407
erevs,FALSE,3834374.5,2660,598,2062,1629
gumbo,TRUE,3834194,1995,444,1551,1219.5
juicy,TRUE,3834136,1996,988,1008,1492
pawky,FALSE,3833727,2068,891,1177,1479.5
ksars,FALSE,3833619,2566,531,2035,1548.5
summa,FALSE,3833350.5,2282,745,1537,1513.5
kerry,FALSE,3833026,2512,941,1571,1726.5
quims,FALSE,3832890,2049,579,1470,1314
loopy,TRUE,3832846,2084,1025,1059,1554.5
jambo,FALSE,3832797,2174,467,1707,1320.5
hebes,FALSE,3832562,2320,722,1598,1521
fests,FALSE,3831903,2548,633,1915,1590.5
poove,FALSE,3831704,2224,1135,1089,1679.5
embox,FALSE,3831080,2331,307,2024,1319
vells,FALSE,3830733,2471,595,1876,1533
shags,FALSE,3830630,2206,929,1277,1567.5
looks,FALSE,3830623,2141,702,1439,1421.5
chana,FALSE,3829960,2286,895,1391,1590.5
ghees,FALSE,3829678.5,2353,790,1563,1571.5
hosts,FALSE,3829525,2337,603,1734,1470
lobos,FALSE,3829282,2206,592,1614,1399
laldy,FALSE,3829271,2344,937,1407,1640.5
scapa,FALSE,3828522,2321,827,1494,1574
smurs,FALSE,3828092,2210,757,1453,1483.5
choux,FALSE,3827616,1994,676,1318,1335
flump,FALSE,3827581,1956,626,1330,1291
zonks,FALSE,3827376,2078,512,1566,1295
khazi,FALSE,3827210,2172,502,1670,1337
cyclo,FALSE,3826981,2186,497,1689,1341.5
rudds,FALSE,3825915,2282,471,1811,1376.5
debes,FALSE,3825827,2311,764,1547,1537.5
shams,FALSE,3825812,2204,921,1283,1562.5
ninth,TRUE,3825603,2243,656,1587,1449.5
bucks,FALSE,3825567,1992,506,1486,1249
arear,FALSE,3824926,2802,960,1842,1881
sposh,FALSE,3824191.5,2016,981,1035,1498.5
snush,FALSE,3824107.5,2004,928,1076,1466
wakfs,FALSE,3823841,2130,470,1660,1300
nylon,TRUE,3823587.5,2288,434,1854,1361
bedes,FALSE,3823495,2311,844,1467,1577.5
tabby,TRUE,3823284,2260,898,1362,1579
feces,FALSE,3823022,2329,788,1541,1558.5
sises,FALSE,3822848,2321,1002,1319,1661.5
macas,FALSE,3822415,2273,666,1607,1469.5
needy,TRUE,3821991.5,2393,889,1504,1641
pyxis,FALSE,3821512,2065,371,1694,1218
educe,FALSE,3821144,2331,833,1498,1582
snogs,FALSE,3820951,2141,809,1332,1475
twilt,FALSE,3820344,2156,874,1282,1515
bijou,FALSE,3820052,2071,511,1560,1291
menge,FALSE,3819861,2204,988,1216,1596
qapik,FALSE,3819725,2133,656,1477,1394.5
laksa,FALSE,3819516,2377,639,1738,1508
keens,FALSE,3818973.5,2426,657,1769,1541.5
colly,FALSE,3818917,2186,1115,1071,1650.5
greek,FALSE,3818555.5,2395,990,1405,1692.5
civie,FALSE,3818012,2300,1031,1269,1665.5
annex,TRUE,3817278,2552,693,1859,1622.5
cutto,FALSE,3816880,2245,692,1553,1468.5
kests,FALSE,3816357,2543,517,2026,1530
shuts,FALSE,3816132,2121,850,1271,1485.5
messy,FALSE,3815576.5,2389,964,1425,1676.5
farad,FALSE,3815192,2323,884,1439,1603.5
glebe,FALSE,3815118.5,2271,941,1330,1606
winna,FALSE,3814669.5,2300,670,1630,1485
igged,FALSE,3814521.5,2373,549,1824,1461
hilch,FALSE,3813708,2122,674,1448,1398
avant,FALSE,3813501,2275,898,1377,1586.5
molls,FALSE,3813444,2237,696,1541,1466.5
naffs,FALSE,3813391,2284,437,1847,1360.5
burbs,FALSE,3813388,2179,582,1597,1380.5
tyiyn,FALSE,3813001,2281,571,1710,1426
playa,FALSE,3811747,2320,717,1603,1518.5
dzhos,FALSE,3811515,2075,290,1785,1182.5
emery,FALSE,3810838.5,2608,803,1805,1705.5
squib,TRUE,3810768,2018,705,1313,1361.5
parma,FALSE,3809627,2390,741,1649,1565.5
daraf,FALSE,3809255,2323,767,1556,1545
weens,FALSE,3809194.5,2418,720,1698,1569
greve,FALSE,3809155.5,2342,1029,1313,1685.5
waacs,FALSE,3809087,2169,882,1287,1525.5
noobs,FALSE,3808595,2108,620,1488,1364
yahoo,FALSE,3808585,2378,509,1869,1443.5
fjord,TRUE,3808172,2114,652,1462,1383
unzip,TRUE,3808165,2035,345,1690,1190
apays,FALSE,3808138,2290,548,1742,1419
lazzo,FALSE,3808010,2265,481,1784,1373
kumys,FALSE,3807907,1992,306,1686,1149
guess,TRUE,3807775.5,2431,685,1746,1558
gymps,FALSE,3807598,1979,285,1694,1132
belly,TRUE,3807579,2388,1053,1335,1720.5
softs,FALSE,3807160,2165,845,1320,1505
kulak,FALSE,3807036.5,2216,594,1622,1405
wests,FALSE,3806578,2535,580,1955,1557.5
succi,FALSE,3806002,2170,771,1399,1470.5
galah,FALSE,3805973,2236,833,1403,1534.5
gally,FALSE,3805758,2274,1057,1217,1665.5
signs,FALSE,3805577,2115,853,1262,1484
feted,FALSE,3805274,2300,925,1375,1612.5
ollav,FALSE,3804236.5,2379,517,1862,1448
yapps,FALSE,3804071,2290,454,1836,1372
cinch,TRUE,3803494,2024,830,1194,1427
diked,FALSE,3803392.5,2275,761,1514,1518
zobus,FALSE,3803228,2050,457,1593,1253.5
gloss,TRUE,3802981.5,2239,767,1472,1503
duped,FALSE,3802690.5,2229,791,1438,1510
shuls,FALSE,3802472,2102,873,1229,1487.5
peaze,FALSE,3802165,2346,1135,1211,1740.5
binit,FALSE,3801905,2131,925,1206,1528
khoja,FALSE,3801752,2190,474,1716,1332
kanas,FALSE,3800889,2279,662,1617,1470.5
hamal,FALSE,3800471,2234,753,1481,1493.5
busky,FALSE,3800045,1961,858,1103,1409.5
lavas,FALSE,3799674,2324,640,1684,1482
gings,FALSE,3799644.5,2115,568,1547,1341.5
caman,FALSE,3799635,2205,856,1349,1530.5
suids,FALSE,3799127,2092,923,1169,1507.5
gunky,FALSE,3798835,1926,859,1067,1392.5
sokol,FALSE,3798354,2141,945,1196,1543
weber,FALSE,3798003,2354,912,1442,1633
bleep,TRUE,3797276.5,2317,925,1392,1621
sings,FALSE,3797143,2115,819,1296,1467
gurus,FALSE,3797102,2212,582,1630,1397
motts,FALSE,3796909,2256,672,1584,1464
swash,TRUE,3796732.5,2100,1027,1073,1563.5
sixes,FALSE,3796514,2358,934,1424,1646
kheth,FALSE,3796177,2304,619,1685,1461.5
pupil,TRUE,3796147,2098,700,1398,1399
deeps,FALSE,3795254.5,2390,616,1774,1503
ewest,FALSE,3795143.5,2535,717,1818,1626
quich,FALSE,3794998,1960,766,1194,1363
chill,TRUE,3794687,2122,926,1196,1524
ippon,FALSE,3793747.5,2216,415,1801,1315.5
benny,FALSE,3793090.5,2290,1100,1190,1695
qophs,FALSE,3792672,2045,424,1621,1234.5
gooly,FALSE,3791999,2038,1164,874,1601
sizes,FALSE,3791992,2356,933,1423,1644.5
achoo,FALSE,3791757,2409,380,2029,1394.5
snigs,FALSE,3791751,2115,831,1284,1473
abray,FALSE,3791163,2430,847,1583,1638.5
betty,FALSE,3791044,2407,1029,1378,1718
cloop,FALSE,3790810,2115,831,1284,1473
tewed,FALSE,3790570,2287,853,1434,1570
monos,FALSE,3790382,2139,693,1446,1416
droog,FALSE,3790111,2180,795,1385,1487.5
bocca,FALSE,3789524,2297,724,1573,1510.5
pipul,FALSE,3789119,2098,640,1458,1369
ulama,FALSE,3788601,2312,673,1639,1492.5
heben,FALSE,3788214,2252,816,1436,1534
mooly,FALSE,3787727,2036,1156,880,1596
cabas,FALSE,3787246,2242,758,1484,1500
soups,FALSE,3787006,2094,896,1198,1495
twist,TRUE,3786579,2126,883,1243,1504.5
punji,FALSE,3785651,2027,480,1547,1253.5
numen,FALSE,3785556.5,2361,732,1629,1546.5
posts,FALSE,3784633,2304,676,1628,1490
venue,TRUE,3783982,2212,930,1282,1571
pudgy,TRUE,3783811,1890,843,1047,1366.5
hists,FALSE,3783619,2311,526,1785,1418.5
angas,FALSE,3783465,2377,494,1883,1435.5
elves,FALSE,3783184,2471,676,1795,1573.5
cusso,FALSE,3782987.5,2196,693,1503,1444.5
durrs,FALSE,3782919,2282,648,1634,1465
gauss,FALSE,3782436.5,2284,791,1493,1537.5
humfs,FALSE,3782243,1959,387,1572,1173
happi,FALSE,3781767,2281,492,1789,1386.5
agood,FALSE,3781001,2252,647,1605,1449.5
razor,TRUE,3780682,2454,764,1690,1609
agave,FALSE,3779973,2414,930,1484,1672
iodin,FALSE,3779947,2240,676,1564,1458
texes,FALSE,3779626,2378,757,1621,1567.5
tunny,FALSE,3779430.5,2091,1020,1071,1555.5
swots,FALSE,3779078,2152,829,1323,1490.5
humpy,FALSE,3777001,1897,730,1167,1313.5
skols,FALSE,3776090,2141,818,1323,1479.5
tanka,FALSE,3774919,2328,711,1617,1519.5
mekka,FALSE,3774692.5,2465,480,1985,1472.5
seres,FALSE,3774546,2511,1125,1386,1818
slows,FALSE,3774158,2133,872,1261,1502.5
cumec,FALSE,3773629.5,2259,794,1465,1526.5
guqin,FALSE,3773417,1983,590,1393,1286.5
lysis,FALSE,3773273,2330,385,1945,1357.5
quoif,FALSE,3773206,2013,637,1376,1325
sykes,FALSE,3772476,2293,755,1538,1524
muses,FALSE,3771994,2429,727,1702,1578
gills,FALSE,3771810,2213,627,1586,1420
helve,FALSE,3771809,2232,893,1339,1562.5
graff,FALSE,3771117,2253,750,1503,1501.5
apgar,FALSE,3770981,2392,644,1748,1518
grama,FALSE,3770491,2344,821,1523,1582.5
dumpy,TRUE,3770266,1888,772,1116,1330
cooms,FALSE,3768838,2037,825,1212,1431
nandu,FALSE,3768760,2286,550,1736,1418
gowfs,FALSE,3768683,1992,491,1501,1241.5
sowls,FALSE,3768436,2133,869,1264,1501
wedel,FALSE,3768374,2268,874,1394,1571
wryly,TRUE,3768145,2096,905,1191,1500.5
usurp,TRUE,3767765,2258,422,1836,1340
refry,FALSE,3767602,2517,888,1629,1702.5
mills,FALSE,3767538,2211,619,1592,1415
fasts,FALSE,3767385,2401,695,1706,1548
sushi,TRUE,3767352,2101,671,1430,1386
primp,FALSE,3767300,2128,799,1329,1463.5
yecch,FALSE,3766848,2300,595,1705,1447.5
mayas,FALSE,3766765,2242,639,1603,1440.5
swede,FALSE,3766103.5,2238,1080,1158,1659
haggs,FALSE,3765763.5,2206,552,1654,1379
abaci,FALSE,3765505,2271,627,1644,1449
battu,FALSE,3765330,2300,728,1572,1514
delve,TRUE,3765074,2223,935,1288,1579
skios,FALSE,3764420,2140,810,1330,1475
skool,FALSE,3764009,2141,908,1233,1524.5
ainga,FALSE,3763999,2406,622,1784,1514
cohos,FALSE,3763990,2118,654,1464,1386
roofy,FALSE,3763598,2134,1027,1107,1580.5
jinks,FALSE,3763490,2044,452,1592,1248
alfas,FALSE,3763292,2382,566,1816,1474
nomoi,FALSE,3762748,2168,520,1648,1344
culls,FALSE,3762377,2171,694,1477,1432.5
sexts,FALSE,3762340,2378,795,1583,1586.5
hoods,FALSE,3761769,2040,697,1343,1368.5
jambs,FALSE,3761759,2119,445,1674,1282
spags,FALSE,3761705,2173,846,1327,1509.5
sifts,FALSE,3761254,2139,768,1371,1453.5
gowks,FALSE,3761218,1987,511,1476,1249
studs,FALSE,3761005,2112,713,1399,1412.5
skits,FALSE,3760550,2134,817,1317,1475.5
mulla,FALSE,3760400,2312,631,1681,1471.5
veery,FALSE,3760339.5,2459,978,1481,1718.5
tasks,FALSE,3760074,2396,624,1772,1510
cooze,FALSE,3760006,2212,1165,1047,1688.5
weave,TRUE,3759982,2308,1102,1206,1705
stook,FALSE,3759824,2160,932,1228,1546
stiff,TRUE,3759364,2139,770,1369,1454.5
fluky,FALSE,3759030,1931,921,1010,1426
kecks,FALSE,3758933.5,2324,409,1915,1366.5
izzat,FALSE,3758698,2258,463,1795,1360.5
sully,TRUE,3758499,2140,1190,950,1665
goosy,FALSE,3758234,2008,1173,835,1590.5
theft,TRUE,3757827,2309,758,1551,1533.5
amici,FALSE,3757654,2302,608,1694,1455
ummas,FALSE,3757159.5,2282,331,1951,1306.5
spams,FALSE,3756887,2171,838,1333,1504.5
yoops,FALSE,3756222,2054,615,1439,1334.5
heyed,FALSE,3756182,2222,776,1446,1499
rooky,FALSE,3756133,2129,1047,1082,1588
award,TRUE,3755739,2310,762,1548,1536
renne,FALSE,3755663.5,2443,1092,1351,1767.5
gassy,TRUE,3755330.5,2244,1034,1210,1639
serre,FALSE,3755243,2511,1347,1164,1929
sewed,FALSE,3755150,2238,1070,1168,1654
ember,TRUE,3755107,2458,697,1761,1577.5
bolls,FALSE,3755019,2206,762,1444,1484
eaved,FALSE,3754783,2484,861,1623,1672.5
jeers,FALSE,3753903.5,2538,627,1911,1582.5
anima,FALSE,3753789,2404,626,1778,1515
rumor,TRUE,3753679,2265,696,1569,1480.5
lazzi,FALSE,3753466,2239,434,1805,1336.5
noggs,FALSE,3753378.5,2141,495,1646,1318
hanap,FALSE,3753373,2184,731,1453,1457.5
cholo,FALSE,3753269,2148,806,1342,1477
toffs,FALSE,3753076,2165,524,1641,1344.5
myxos,FALSE,3752793,2043,310,1733,1176.5
samps,FALSE,3752225,2171,817,1354,1494
snobs,FALSE,3752075,2108,757,1351,1432.5
ducky,FALSE,3751948,1894,772,1122,1333
boson,FALSE,3751516,2108,794,1314,1451
massy,FALSE,3751058.5,2242,1026,1216,1634
mitts,FALSE,3751003,2230,595,1635,1412.5
klutz,FALSE,3750347,2009,529,1480,1269
swits,FALSE,3749878,2126,851,1275,1488.5
gelee,FALSE,3749843,2004,1211,793,1607.5
scaff,FALSE,3749780,2182,774,1408,1478
crook,TRUE,3749392,2160,954,1206,1557
gawky,TRUE,3749260,2022,864,1158,1443
abacs,FALSE,3749011,2242,652,1590,1447
stows,FALSE,3748741,2152,748,1404,1450
gutta,FALSE,3748137,2333,615,1718,1474
doved,FALSE,3747826.5,2248,875,1373,1561.5
docos,FALSE,3747767,2109,614,1495,1361.5
cuvee,FALSE,3747555,2110,1175,935,1642.5
theek,FALSE,3747486.5,2304,901,1403,1602.5
vises,FALSE,3747357,2470,679,1791,1574.5
dazed,FALSE,3747238.5,2370,862,1508,1616
naval,TRUE,3747179,2256,709,1547,1482.5
quack,TRUE,3747103,2045,781,1264,1413
tokos,FALSE,3746504,2160,608,1552,1384
breve,FALSE,3746458.5,2309,1087,1222,1698
nomos,FALSE,3746254,2139,545,1594,1342
melee,TRUE,3745571,2002,1203,799,1602.5
mawky,FALSE,3744988,2020,856,1164,1438
cecum,FALSE,3744935,2259,620,1639,1439.5
toddy,TRUE,3744907,2127,936,1191,1531.5
purrs,FALSE,3744762,2258,679,1579,1468.5
sunny,TRUE,3744010.5,2042,1237,805,1639.5
takky,FALSE,3743693.5,2195,884,1311,1539.5
bally,FALSE,3743061,2241,1115,1126,1678
moove,FALSE,3742965,2176,1100,1076,1638
booty,TRUE,3742962,2024,1199,825,1611.5
pisos,FALSE,3742597,2284,592,1692,1438
wasts,FALSE,3742060,2388,642,1746,1515
jetes,FALSE,3741490,2368,727,1641,1547.5
naggy,FALSE,3741420.5,2176,848,1328,1512
taffy,TRUE,3741118,2200,877,1323,1538.5
nappy,FALSE,3740930,2222,813,1409,1517.5
amnia,FALSE,3740793,2404,540,1864,1472
semee,FALSE,3740321,1972,1411,561,1691.5
exile,TRUE,3739898,2388,938,1450,1663
spics,FALSE,3739263,2059,881,1178,1470
fuzed,FALSE,3739162,2125,769,1356,1447
brood,TRUE,3739057,2147,934,1213,1540.5
fuzil,FALSE,3739014,1994,647,1347,1320.5
elven,FALSE,3738836,2403,770,1633,1586.5
botts,FALSE,3738484,2225,738,1487,1481.5
scops,FALSE,3737206,2085,736,1349,1410.5
sujee,FALSE,3736831,2158,1297,861,1727.5
exeat,FALSE,3736146.5,2669,679,1990,1674
villa,TRUE,3735763,2353,583,1770,1468
twill,FALSE,3735659,2156,777,1379,1466.5
alack,FALSE,3735427,2207,914,1293,1560.5
fytte,FALSE,3734728,2347,833,1514,1590
icily,TRUE,3734428,2160,866,1294,1513
popsy,FALSE,3734142,2054,1014,1040,1534
sacks,FALSE,3733907,2177,817,1360,1497
ensew,FALSE,3733089,2418,574,1844,1496
lexes,FALSE,3732724,2359,696,1663,1527.5
kotos,FALSE,3732398,2160,578,1582,1369
unmix,FALSE,3730628,1989,347,1642,1168
goold,FALSE,3730627,1991,918,1073,1454.5
abeam,FALSE,3730362,2530,539,1991,1534.5
verry,FALSE,3729852,2459,964,1495,1711.5
polyp,TRUE,3728724,2084,592,1492,1338
scoop,TRUE,3728545,2085,838,1247,1461.5
lezes,FALSE,3728202,2357,695,1662,1526
serer,FALSE,3727952,2511,1301,1210,1906
akita,FALSE,3727406,2425,620,1805,1522.5
sauba,FALSE,3726643,2251,923,1328,1587
batty,TRUE,3726526,2260,1091,1169,1675.5
minis,FALSE,3726070,2113,642,1471,1377.5
sense,TRUE,3725520.5,2224,1342,882,1783
nisus,FALSE,3725464,2272,437,1835,1354.5
mirid,FALSE,3724827,2152,748,1404,1450
kliks,FALSE,3724678.5,2115,578,1537,1346.5
woons,FALSE,3724629,2035,824,1211,1429.5
droob,FALSE,3724624,2147,765,1382,1456
codon,FALSE,3724343,2041,814,1227,1427.5
phish,FALSE,3723983,1990,862,1128,1426
ascus,FALSE,3723645,2432,331,2101,1381.5
edema,FALSE,3723418.5,2633,401,2232,1517
mhorr,FALSE,3722988,2187,859,1328,1523
knack,TRUE,3722931.5,2109,679,1430,1394
silks,FALSE,3722899,2115,771,1344,1443
snibs,FALSE,3722875,2082,779,1303,1430.5
cissy,FALSE,3722583.5,2130,1015,1115,1572.5
mayan,FALSE,3722417,2174,733,1441,1453.5
jinne,FALSE,3721236.5,2280,967,1313,1623.5
titch,FALSE,3720344,2141,753,1388,1447
poohs,FALSE,3720030,2016,729,1287,1372.5
vitta,FALSE,3719228,2372,559,1813,1465.5
yarfa,FALSE,3718987,2370,572,1798,1471
couch,TRUE,3718807,1957,933,1024,1445
hooka,FALSE,3718697,2163,711,1452,1437
rajas,FALSE,3718338,2391,611,1780,1501
cheep,FALSE,3717635.5,2229,893,1336,1561
folio,TRUE,3717524,2175,743,1432,1459
hoops,FALSE,3717424,2016,678,1338,1347
haoma,FALSE,3717313,2259,749,1510,1504
jarta,FALSE,3717203,2440,690,1750,1565
kelep,FALSE,3717172,2252,748,1504,1500
cooee,FALSE,3716927,2177,1463,714,1820
poods,FALSE,3716877,2007,770,1237,1388.5
gaddi,FALSE,3716700,2226,574,1652,1400
choon,FALSE,3716167,2050,848,1202,1449
deems,FALSE,3715886.5,2342,634,1708,1488
chowk,FALSE,3715824,1896,724,1172,1310
skink,FALSE,3714585.5,2017,937,1080,1477
kebab,TRUE,3714436,2434,493,1941,1463.5
oggin,FALSE,3713695.5,2170,408,1762,1289
buses,FALSE,3713569,2398,793,1605,1595.5
vests,FALSE,3713183,2490,540,1950,1515
oboli,FALSE,3713078,2235,474,1761,1354.5
meeds,FALSE,3712703.5,2342,631,1711,1486.5
sysop,FALSE,3712596,2054,657,1397,1355.5
colog,FALSE,3712585,2069,762,1307,1415.5
whomp,FALSE,3712233,1890,595,1295,1242.5
wimpy,TRUE,3712128,1902,760,1142,1331
wheel,TRUE,3711860.5,2277,878,1399,1577.5
kolos,FALSE,3711714,2141,579,1562,1360
upbow,FALSE,3711504,1937,300,1637,1118.5
bliss,TRUE,3711084.5,2180,847,1333,1513.5
ungag,FALSE,3711071,2216,391,1825,1303.5
skill,TRUE,3710911,2115,960,1155,1537.5
tweed,TRUE,3710479.5,2287,806,1481,1546.5
dekko,FALSE,3710190.5,2301,478,1823,1389.5
scaws,FALSE,3709957,2169,774,1395,1471.5
caffs,FALSE,3709576,2182,598,1584,1390
soddy,FALSE,3709487,2078,1153,925,1615.5
bever,FALSE,3709242,2309,994,1315,1651.5
zingy,FALSE,3709143,1949,784,1165,1366.5
bills,FALSE,3709113,2180,685,1495,1432.5
fucks,FALSE,3708501,1932,469,1463,1200.5
soums,FALSE,3707638,2046,914,1132,1480
deffo,FALSE,3707615,2306,471,1835,1388.5
cubeb,FALSE,3707442,2228,770,1458,1499
tiffs,FALSE,3707170,2139,447,1692,1293
yucca,FALSE,3704898,2231,464,1767,1347.5
haafs,FALSE,3704502,2113,751,1362,1432
skuas,FALSE,3704338,2186,740,1446,1463
juked,FALSE,3704108,2112,654,1458,1383
kapok,FALSE,3704054.5,2130,627,1503,1378.5
vibex,FALSE,3703870,2156,628,1528,1392
offed,FALSE,3703654,2306,510,1796,1408
apeak,FALSE,3703254,2513,655,1858,1584
hullo,FALSE,3702633,2157,587,1570,1372
boysy,FALSE,3702487,1975,1016,959,1495.5
zygon,FALSE,3702363,1975,355,1620,1165
queer,TRUE,3702151.5,2379,916,1463,1647.5
krewe,FALSE,3702073.5,2289,913,1376,1601
bulla,FALSE,3701975,2281,697,1584,1489
dived,FALSE,3701920.5,2222,798,1424,1510
guana,FALSE,3701747,2216,854,1362,1535
stymy,FALSE,3701564,2000,904,1096,1452
caddy,TRUE,3701407,2144,1010,1134,1577
imino,FALSE,3701394,2168,578,1590,1373
swill,TRUE,3700239,2107,994,1113,1550.5
fleme,FALSE,3699413.5,2209,1006,1203,1607.5
booth,TRUE,3699308,1986,974,1012,1480
tiddy,FALSE,3699001,2101,859,1242,1480
indri,FALSE,3698978,2404,359,2045,1381.5
towzy,FALSE,3698090,1986,838,1148,1412
awake,TRUE,3697530,2361,971,1390,1666
rubus,FALSE,3697111,2179,466,1713,1322.5
zouks,FALSE,3696783,1985,538,1447,1261.5
obols,FALSE,3696584,2206,499,1707,1352.5
dekes,FALSE,3696147,2246,719,1527,1482.5
mosts,FALSE,3695894,2256,641,1615,1448.5
yabas,FALSE,3695262,2211,566,1645,1388.5
kacks,FALSE,3694415.5,2177,471,1706,1324
unbox,FALSE,3693911,1984,317,1667,1150.5
wicky,FALSE,3693810,1908,760,1148,1334
cacks,FALSE,3693352,2177,649,1528,1413
makar,FALSE,3693041,2246,798,1448,1522
bassy,FALSE,3692633.5,2211,1092,1119,1651.5
bitts,FALSE,3692578,2199,661,1538,1430
krunk,FALSE,3691912.5,2046,747,1299,1396.5
acock,FALSE,3691719,2232,690,1542,1461
chili,TRUE,3691406,2122,781,1341,1451.5
nooks,FALSE,3690858,2043,651,1392,1347
felly,FALSE,3690513,2328,1016,1312,1672
rigid,TRUE,3690433,2154,650,1504,1402
abash,FALSE,3690192,2173,774,1399,1473.5
looby,FALSE,3689420,2005,999,1006,1502
assez,FALSE,3688955,2618,559,2059,1588.5
occam,FALSE,3688544,2328,342,1986,1335
syncs,FALSE,3688469,2033,716,1317,1374.5
holly,TRUE,3688135,2117,986,1131,1551.5
nouny,FALSE,3687635.5,2097,1027,1070,1562
savvy,TRUE,3687600,2093,1129,964,1611
emmys,FALSE,3687469.5,2389,210,2179,1299.5
jaded,FALSE,3687456.5,2362,835,1527,1598.5
belee,FALSE,3687146,1971,1269,702,1620
thigh,TRUE,3686480,1993,774,1219,1383.5
dholl,FALSE,3686370,2070,817,1253,1443.5
skeed,FALSE,3685731.5,2246,989,1257,1617.5
yawny,FALSE,3684163,2070,882,1188,1476
yewen,FALSE,3684068,2217,722,1495,1469.5
trooz,FALSE,3682915,2212,796,1416,1504
pulps,FALSE,3682887,2069,526,1543,1297.5
tikis,FALSE,3682192,2134,557,1577,1345.5
devel,FALSE,3681945,2223,876,1347,1549.5
lisps,FALSE,3681447,2259,456,1803,1357.5
dunno,FALSE,3681409.5,2050,676,1374,1363
dolly,TRUE,3681400,2108,1028,1080,1568
comic,TRUE,3681379.5,2066,727,1339,1396.5
pasha,FALSE,3681331,2252,618,1634,1435
shuns,FALSE,3681250,2004,893,1111,1448.5
toppy,FALSE,3680615,2103,900,1203,1501.5
fewer,TRUE,3680384,2294,934,1360,1614
cynic,TRUE,3679271.5,2062,549,1513,1305.5
jouks,FALSE,3678803,1977,555,1422,1266
nixie,FALSE,3678779,2290,833,1457,1561.5
exert,TRUE,3677700.5,2597,668,1929,1632.5
cycad,FALSE,3676335,2144,558,1586,1351
lavvy,FALSE,3676118,2123,851,1272,1487
fenny,FALSE,3676024.5,2230,1063,1167,1646.5
sweed,FALSE,3675059.5,2238,1023,1215,1630.5
kelly,FALSE,3674967,2323,900,1423,1611.5
churr,FALSE,3674945,2121,871,1250,1496
pulus,FALSE,3674869,2069,558,1511,1313.5
sugos,FALSE,3674755,2048,787,1261,1417.5
sweys,FALSE,3674523,2285,626,1659,1455.5
quaky,FALSE,3674481,2014,935,1079,1474.5
pooka,FALSE,3673805,2130,784,1346,1457
geeps,FALSE,3672630.5,2320,620,1700,1470
murri,FALSE,3672517,2239,619,1620,1429
acmic,FALSE,3672056.5,2302,431,1871,1366.5
hotty,FALSE,3671600,2136,962,1174,1549
razoo,FALSE,3671589,2454,610,1844,1532
amahs,FALSE,3671289,2204,550,1654,1377
goony,FALSE,3670777,1940,1184,756,1562
beedi,FALSE,3670772.5,2340,672,1668,1506
sumos,FALSE,3670167,2046,781,1265,1413.5
glugs,FALSE,3670028.5,2023,593,1430,1308
momus,FALSE,3669401,2046,565,1481,1305.5
burro,FALSE,3668636,2234,732,1502,1483
rurps,FALSE,3668601,2258,540,1718,1399
upped,FALSE,3668553.5,2229,588,1641,1408.5
heugh,FALSE,3668268,2192,691,1501,1441.5
ribby,FALSE,3667944,2168,752,1416,1460
slugs,FALSE,3667527,2023,844,1179,1433.5
surfs,FALSE,3667490,2119,786,1333,1452.5
hedge,TRUE,3667388,2105,886,1219,1495.5
cutch,FALSE,3666973,1951,786,1165,1368.5
donny,FALSE,3666911.5,2010,1075,935,1542.5
moony,FALSE,3666505,1938,1176,762,1557
welly,FALSE,3665188,2315,963,1352,1639
oozes,FALSE,3665041,2382,685,1697,1533.5
dotty,FALSE,3664865,2127,1004,1123,1565.5
hesps,FALSE,3664491,2399,477,1922,1438
groom,TRUE,3664186,2108,800,1308,1454
shama,FALSE,3664002,2204,949,1255,1576.5
igloo,TRUE,3663847,2268,348,1920,1308
kombu,FALSE,3663191,1897,385,1512,1141
tofts,FALSE,3663090,2165,628,1537,1396.5
fillo,FALSE,3663085,2175,670,1505,1422.5
tommy,FALSE,3662874.5,2055,921,1134,1488
slums,FALSE,3662709,2021,836,1185,1428.5
scogs,FALSE,3662656,2039,762,1277,1400.5
shchi,FALSE,3662574,2092,605,1487,1348.5
jowly,FALSE,3662456,1959,851,1108,1405
daman,FALSE,3662118,2127,769,1358,1448
curry,TRUE,3661496,2159,1063,1096,1611
bambi,FALSE,3660919,2121,573,1548,1347
asses,FALSE,3660529,2583,591,1992,1587
keema,FALSE,3660389.5,2465,571,1894,1518
mambo,TRUE,3660213,2147,554,1593,1350.5
vughs,FALSE,3660185,1903,360,1543,1131.5
furor,TRUE,3660032,2174,829,1345,1501.5
smuts,FALSE,3659494,2040,744,1296,1392
cauda,FALSE,3659352,2184,800,1384,1492
tweep,FALSE,3658607.5,2263,744,1519,1503.5
hexer,FALSE,3658250,2309,853,1456,1581
pekes,FALSE,3657990,2222,750,1472,1486
pinup,FALSE,3657597,2000,621,1379,1310.5
isbas,FALSE,3657555,2441,306,2135,1373.5
promo,FALSE,3657045,2154,779,1375,1466.5
clock,TRUE,3656113,1971,908,1063,1439.5
whews,FALSE,3656078,2247,465,1782,1356
murrs,FALSE,3656023,2210,644,1566,1427
talaq,FALSE,3655786,2253,728,1525,1490.5
sojas,FALSE,3655146,2227,847,1380,1537
medii,FALSE,3654572,2371,593,1778,1482
gists,FALSE,3654260,2232,572,1660,1402
misos,FALSE,3653858,2236,557,1679,1396.5
kerve,FALSE,3653841,2244,895,1349,1569.5
smeke,FALSE,3653467.5,2174,1060,1114,1617
luffa,FALSE,3653130,2221,398,1823,1309.5
vegie,FALSE,3652816,2152,934,1218,1543
sways,FALSE,3652304,2138,756,1382,1447
shops,FALSE,3652054,2016,840,1176,1428
lupus,TRUE,3651853,2069,450,1619,1259.5
zooey,FALSE,3651360,2181,1208,973,1694.5
frory,FALSE,3651006,2134,1163,971,1648.5
wenny,FALSE,3650699.5,2217,1010,1207,1613.5
quonk,FALSE,3650295,1911,748,1163,1329.5
elegy,TRUE,3650273.5,2421,890,1531,1655.5
sumis,FALSE,3650147,2020,807,1213,1413.5
masus,FALSE,3650124,2282,609,1673,1445.5
unman,FALSE,3650031.5,2214,474,1740,1344
mists,FALSE,3649988,2230,564,1666,1397
blini,FALSE,3649825,2112,833,1279,1472.5
uncut,TRUE,3649487,2122,511,1611,1316.5
titup,FALSE,3649202,2117,600,1517,1358.5
debye,FALSE,3648848,2110,837,1273,1473.5
vasts,FALSE,3648665,2343,602,1741,1472.5
ngwee,FALSE,3648022,2100,817,1283,1458.5
halma,FALSE,3647819,2234,617,1617,1425.5
adyta,FALSE,3647486,2363,393,1970,1378
uprun,FALSE,3647087,2190,469,1721,1329.5
wojus,FALSE,3647081,1969,483,1486,1226
shews,FALSE,3647024,2247,748,1499,1497.5
bedye,FALSE,3646516,2110,917,1193,1513.5
culch,FALSE,3646289,1932,787,1145,1359.5
scoog,FALSE,3646150,2039,823,1216,1431
soggy,TRUE,3645685.5,2008,1152,856,1580
soppy,FALSE,3645195,2054,1117,937,1585.5
aquae,FALSE,3643797,2451,898,1553,1674.5
polly,FALSE,3643243,2084,1059,1025,1571.5
hilly,TRUE,3642229,2091,909,1182,1500
putto,FALSE,3641206,2143,636,1507,1389.5
yeves,FALSE,3640208,2240,651,1589,1445.5
jocks,FALSE,3639885,1968,446,1522,1207
vulva,FALSE,3638944,2163,451,1712,1307
besee,FALSE,3638684,1941,1237,704,1589
towts,FALSE,3638026,2152,629,1523,1390.5
wilis,FALSE,3637623,2107,591,1516,1349
flurr,FALSE,3637520,2149,866,1283,1507.5
kyaks,FALSE,3637469.5,2146,441,1705,1293.5
stums,FALSE,3637292,2040,712,1328,1376
jello,FALSE,3636395,2404,594,1810,1499
dilly,TRUE,3635494,2082,951,1131,1516.5
almah,FALSE,3635315,2234,705,1529,1469.5
sophs,FALSE,3635196,2016,767,1249,1391.5
tippy,FALSE,3634709,2077,823,1254,1450
blubs,FALSE,3634277,1990,599,1391,1294.5
loggy,FALSE,3634203.5,2038,874,1164,1456
loppy,FALSE,3633713,2084,839,1245,1461.5
fujis,FALSE,3633528,1956,519,1437,1237.5
skeds,FALSE,3632906,2246,658,1588,1452
dinic,FALSE,3632611,2015,641,1374,1328
goods,FALSE,3632410,1961,743,1218,1352
gizmo,FALSE,3632367,1953,454,1499,1203.5
edges,FALSE,3632248,2344,513,1831,1428.5
ozone,TRUE,3632170,2314,893,1421,1603.5
maggs,FALSE,3632132.5,2125,590,1535,1357.5
hygge,FALSE,3632091.5,2152,659,1493,1405.5
bewet,FALSE,3631822,2184,1012,1172,1598
kabar,FALSE,3631684,2215,756,1459,1485.5
hulls,FALSE,3631595,2102,565,1537,1333.5
comms,FALSE,3631332.5,2037,642,1395,1339.5
dooms,FALSE,3631321,1959,738,1221,1348.5
purpy,FALSE,3630647,2057,905,1152,1481
visit,TRUE,3630026,2081,736,1345,1408.5
undid,TRUE,3629965.5,2024,471,1553,1247.5
gucky,FALSE,3629324,1824,776,1048,1300
condo,TRUE,3629020,2041,743,1298,1392
pagan,TRUE,3628549,2105,806,1299,1455.5
moods,FALSE,3628138,1959,735,1224,1347
jacky,FALSE,3627927,2003,799,1204,1401
parka,TRUE,3627832,2294,728,1566,1511
hinny,FALSE,3627740.5,1993,956,1037,1474.5
spods,FALSE,3627474,2007,776,1231,1391.5
yeuky,FALSE,3627310,2132,832,1300,1482
click,TRUE,3626913,1945,930,1015,1437.5
potty,FALSE,3626708,2103,1035,1068,1569
snook,FALSE,3626209,2043,942,1101,1492.5
footy,FALSE,3625896,1964,1162,802,1563
sniff,TRUE,3625749,2022,780,1242,1401
skins,FALSE,3625668,2017,860,1157,1438.5
buroo,FALSE,3625143,2234,712,1522,1473
mucky,TRUE,3625052,1822,768,1054,1295
dulls,FALSE,3624860,2093,607,1486,1350
shaws,FALSE,3624805,2100,878,1222,1489
floss,TRUE,3623218.5,2146,788,1358,1467
dobro,FALSE,3623197,2147,657,1490,1402
sweep,TRUE,3623187.5,2214,961,1253,1587.5
nongs,FALSE,3623019,2141,567,1574,1354
ships,FALSE,3622854,1990,862,1128,1426
osmol,FALSE,3622759,2237,406,1831,1321.5
tatts,FALSE,3622346,2194,739,1455,1466.5
xenon,FALSE,3621752.5,2316,643,1673,1479.5
swoon,TRUE,3621719,2035,916,1119,1475.5
sunup,FALSE,3621052,1971,829,1142,1400
khaki,TRUE,3621019.5,2137,537,1600,1337
stumm,FALSE,3620770,2040,718,1322,1379
funky,TRUE,3619072,1833,880,953,1356.5
wenge,FALSE,3619045,2100,964,1136,1532
ditty,TRUE,3618959,2101,927,1174,1514
elpee,FALSE,3618706,2050,1073,977,1561.5
exine,FALSE,3618676,2290,958,1332,1624
psyop,FALSE,3618350,2054,375,1679,1214.5
texts,FALSE,3618270,2378,578,1800,1478
tenne,FALSE,3618115.5,2273,1136,1137,1704.5
yaffs,FALSE,3617592,2151,406,1745,1278.5
bilby,FALSE,3617322,1979,875,1104,1427
tifts,FALSE,3617184,2139,551,1588,1345
konks,FALSE,3616944.5,2043,529,1514,1286
emerg,FALSE,3615199.5,2491,480,2011,1485.5
snows,FALSE,3615126,2035,758,1277,1396.5
evets,FALSE,3614978.5,2490,439,2051,1464.5
veney,FALSE,3614873,2172,1106,1066,1639
womby,FALSE,3614608,1849,811,1038,1330
event,TRUE,3614356.5,2422,699,1723,1560.5
panda,FALSE,3614271,2175,718,1457,1446.5
ezine,FALSE,3613934,2288,946,1342,1617
avian,TRUE,3613261,2255,715,1540,1485
facta,FALSE,3612719,2231,699,1532,1465
alkyl,FALSE,3612422.5,2176,513,1663,1344.5
kylix,FALSE,3612218,1951,321,1630,1136
dwell,TRUE,3612205,2268,650,1618,1459
knoll,TRUE,3611884,2073,669,1404,1371
drook,FALSE,3611875,2082,867,1215,1474.5
fanny,TRUE,3611506.5,2083,1125,958,1604
sinks,FALSE,3610530,2017,798,1219,1407.5
bwazi,FALSE,3610312,2052,555,1497,1303.5
beeps,FALSE,3609933.5,2287,678,1609,1482.5
mimsy,FALSE,3609882,1980,905,1075,1442.5
fatty,TRUE,3609460,2200,1054,1146,1627
emeus,FALSE,3608428.5,2429,405,2024,1417
bulbs,FALSE,3606688,1990,531,1459,1260.5
adobo,FALSE,3606461,2219,487,1732,1353
debud,FALSE,3606146.5,2150,610,1540,1380
twits,FALSE,3605808,2126,634,1492,1380
risks,FALSE,3604734,2304,478,1826,1391
iodic,FALSE,3603940,2138,577,1561,1357.5
newed,FALSE,3603903,2170,741,1429,1455.5
haugh,FALSE,3603750,2045,753,1292,1399
pulli,FALSE,3603197,2098,613,1485,1355.5
cogon,FALSE,3602679,1971,806,1165,1388.5
kurus,FALSE,3601793,2114,487,1627,1300.5
kamik,FALSE,3601579.5,2056,656,1400,1356
broom,TRUE,3601489,2075,858,1217,1466.5
ummed,FALSE,3601383.5,2181,568,1613,1374.5
mamee,FALSE,3601322,2263,1214,1049,1738.5
wicca,FALSE,3601227,2198,557,1641,1377.5
seers,FALSE,3600943.5,2511,973,1538,1742
sudsy,FALSE,3600731.5,1862,1162,700,1512
wally,FALSE,3600670,2168,1025,1143,1596.5
swads,FALSE,3600015,2091,822,1269,1456.5
hasps,FALSE,3599973,2252,539,1713,1395.5
klick,FALSE,3599637.5,1945,752,1193,1348.5
gleek,FALSE,3599342.5,2206,924,1282,1565
dwaal,FALSE,3599290,2121,781,1340,1451
sippy,FALSE,3599289,2028,1040,988,1534
slubs,FALSE,3598651,1990,792,1198,1391
burrs,FALSE,3597598,2179,710,1469,1444.5
kahal,FALSE,3597354,2138,652,1486,1395
speks,FALSE,3597311,2222,695,1527,1458.5
selle,FALSE,3597184,2322,1306,1016,1814
sawah,FALSE,3596770,2100,998,1102,1549
bikie,FALSE,3596646,2172,969,1203,1570.5
facia,FALSE,3596569,2211,718,1493,1464.5
fuses,FALSE,3596503,2338,756,1582,1547
cuppa,FALSE,3596029,2160,556,1604,1358
yeven,FALSE,3595860,2172,745,1427,1458.5
tight,TRUE,3595549,1993,699,1294,1346
primi,FALSE,3595182,2128,754,1374,1441
yomim,FALSE,3594999.5,2035,546,1489,1290.5
tuque,FALSE,3594873,2209,842,1367,1525.5
coofs,FALSE,3594508,1946,792,1154,1369
ameba,FALSE,3594191,2530,444,2086,1487
ewhow,FALSE,3593940.5,2302,274,2028,1288
evohe,FALSE,3593858,2257,783,1474,1520
afald,FALSE,3593355,2134,736,1398,1435
unban,FALSE,3593294.5,2183,470,1713,1326.5
abram,FALSE,3592223,2311,525,1786,1418
fever,TRUE,3592176,2249,957,1292,1603
fills,FALSE,3592047,2120,648,1472,1384
hissy,FALSE,3591801.5,2061,886,1175,1473.5
photo,TRUE,3591255,2065,727,1338,1396
askos,FALSE,3591005,2402,337,2065,1369.5
likin,FALSE,3590942,2047,590,1457,1318.5
nutty,TRUE,3590717,2091,837,1254,1464
bumfs,FALSE,3590187,1847,491,1356,1169
awave,FALSE,3590091,2308,962,1346,1635
idyll,TRUE,3590051,2082,401,1681,1241.5
bobak,FALSE,3588687,2051,785,1266,1418
skeps,FALSE,3588561,2222,639,1583,1430.5
goops,FALSE,3588065,1937,724,1213,1330.5
lippy,FALSE,3587807,2058,762,1296,1410
heedy,FALSE,3587394.5,2222,921,1301,1571.5
cooks,FALSE,3587043,1941,812,1129,1376.5
wooly,TRUE,3586911,1932,1132,800,1532
pulls,FALSE,3586703,2069,638,1431,1353.5
putti,FALSE,3586662,2117,589,1528,1353
aband,FALSE,3585017,2096,764,1332,1430
bumpy,FALSE,3584945,1785,834,951,1309.5
chaya,FALSE,3584942,2153,716,1437,1434.5
mieve,FALSE,3584693.5,2150,956,1194,1553
lipid,TRUE,3583850,2011,624,1387,1317.5
gamas,FALSE,3583842,2125,679,1446,1402
moops,FALSE,3583793,1935,716,1219,1325.5
furzy,FALSE,3583330,1953,869,1084,1411
sooky,FALSE,3583165,1910,1308,602,1609
wefte,FALSE,3583156,2124,913,1211,1518.5
pinny,FALSE,3582848.5,1960,1029,931,1494.5
visas,FALSE,3582821,2323,524,1799,1423.5
oddly,TRUE,3582021.5,2108,662,1446,1385
wheen,FALSE,3580242.5,2179,852,1327,1515.5
femes,FALSE,3580177,2179,793,1386,1486
kukri,FALSE,3580051,2143,381,1762,1262
digit,TRUE,3579458,1984,791,1193,1387.5
sabha,FALSE,3579067,2173,819,1354,1496
haffs,FALSE,3578794,2113,469,1644,1291
teste,FALSE,3578235,2341,1034,1307,1687.5
spews,FALSE,3578099,2214,665,1549,1439.5
proof,TRUE,3577897,2063,811,1252,1437
ugged,FALSE,3577581.5,2183,548,1635,1365.5
shogs,FALSE,3577504,1970,866,1104,1418
typto,FALSE,3576736,2103,427,1676,1265
kills,FALSE,3576501,2115,532,1583,1323.5
added,FALSE,3576358.5,2335,672,1663,1503.5
elfed,FALSE,3576144,2281,734,1547,1507.5
fitts,FALSE,3575512,2139,624,1515,1381.5
ruffs,FALSE,3575144,2119,387,1732,1253
ilium,FALSE,3573723,2050,625,1425,1337.5
stubs,FALSE,3573234,2009,668,1341,1338.5
boohs,FALSE,3572866,1937,760,1177,1348.5
daffs,FALSE,3572059,2104,511,1593,1307.5
bhoot,FALSE,3571937,1986,946,1040,1466
adhan,FALSE,3571699,2208,463,1745,1335.5
looky,FALSE,3571683,1940,1030,910,1485
jeels,FALSE,3571645.5,2349,637,1712,1493
kibbe,FALSE,3571178,2172,727,1445,1449.5
wuses,FALSE,3571178,2325,703,1622,1514
qanat,FALSE,3571115,2155,882,1273,1518.5
kinks,FALSE,3571038.5,2017,452,1565,1234.5
serrs,FALSE,3570456,2511,959,1552,1735
putts,FALSE,3570168,2088,614,1474,1351
appuy,FALSE,3568837.5,2129,706,1423,1417.5
seles,FALSE,3567846,2322,1074,1248,1698
doobs,FALSE,3567263,1928,694,1234,1311
ruddy,TRUE,3566975,2081,799,1282,1440
geese,TRUE,3566917.5,1974,1129,845,1551.5
wills,FALSE,3566722,2107,595,1512,1351
sodom,FALSE,3565873,1959,894,1065,1426.5
jells,FALSE,3565357,2349,572,1777,1460.5
eevns,FALSE,3565309,2373,581,1792,1477
hutch,TRUE,3564818,1951,657,1294,1304
labda,FALSE,3564432,2194,582,1612,1388
eiked,FALSE,3563367,2275,722,1553,1498.5
cruck,FALSE,3562870,1944,895,1049,1419.5
shwas,FALSE,3561732,2100,735,1365,1417.5
lalls,FALSE,3561551,2175,702,1473,1438.5
adzed,FALSE,3561360,2370,608,1762,1489
cloff,FALSE,3558919,1976,704,1272,1340
golly,TRUE,3558776,2038,1032,1006,1535
yolky,FALSE,3558772,1940,816,1124,1378
noddy,FALSE,3558240,2010,824,1186,1417
agami,FALSE,3557927,2154,539,1615,1346.5
kneed,TRUE,3557504.5,2178,720,1458,1449
awash,TRUE,3557434,2100,802,1298,1451
alpha,TRUE,3557123,2282,492,1790,1387
cavas,FALSE,3556094,2124,750,1374,1437
unfix,FALSE,3556011,1898,311,1587,1104.5
spaws,FALSE,3555880,2067,795,1272,1431
swaps,FALSE,3555670,2067,803,1264,1435
smeek,FALSE,3555428.5,2174,1012,1162,1593
pooch,TRUE,3555272,1846,956,890,1401
eched,FALSE,3554985,2253,557,1696,1405
stoss,FALSE,3554572.5,1958,894,1064,1426
fifty,TRUE,3554530,1938,866,1072,1402
molly,FALSE,3554504,2036,1024,1012,1530
skosh,FALSE,3554278.5,1872,930,942,1401
evhoe,FALSE,3554096,2257,652,1605,1454.5
suses,FALSE,3553274,2131,986,1145,1558.5
skulk,TRUE,3552551.5,1925,816,1109,1370.5
eejit,FALSE,3552515,2397,728,1669,1562.5
pecke,FALSE,3552476,2052,919,1133,1485.5
winns,FALSE,3552233.5,2009,642,1367,1325.5
watap,FALSE,3551979,2116,717,1399,1416.5
skyrs,FALSE,3551324,2074,593,1481,1333.5
exies,FALSE,3550637,2358,706,1652,1532
finis,FALSE,3550579,2022,671,1351,1346.5
ivied,FALSE,3550304,2222,751,1471,1486.5
weeny,FALSE,3550254.5,2217,1048,1169,1632.5
zombi,FALSE,3549251,1920,378,1542,1149
tagma,FALSE,3548946,2174,652,1522,1413
timid,TRUE,3548297,1982,688,1294,1335
synds,FALSE,3547480,1955,633,1322,1294
pissy,FALSE,3546909.5,2028,959,1069,1493.5
nyaff,FALSE,3546325,2083,428,1655,1255.5
jeune,FALSE,3545883,2090,1033,1057,1561.5
cysts,FALSE,3545843,2150,476,1674,1313
lichi,FALSE,3545562,2122,385,1737,1253.5
tatar,FALSE,3545178,2413,939,1474,1676
welke,FALSE,3544801,2100,916,1184,1508
cobbs,FALSE,3544760,2006,594,1412,1300
enews,FALSE,3544356.5,2418,397,2021,1407.5
tavah,FALSE,3543982,2104,804,1300,1454
bocci,FALSE,3543582,2035,671,1364,1353
shims,FALSE,3543486,1942,880,1062,1411
hippo,TRUE,3543423,2045,437,1608,1241
lezzy,FALSE,3542550,2156,725,1431,1440.5
recce,FALSE,3542221,2341,979,1362,1660
yampy,FALSE,3542192,1970,785,1185,1377.5
feued,FALSE,3541628,2090,979,1111,1534.5
jambu,FALSE,3541623,1958,410,1548,1184
bumph,FALSE,3541291,1747,609,1138,1178
tenet,TRUE,3539603,2273,1101,1172,1687
marka,FALSE,3539093,2246,693,1553,1469.5
dexie,FALSE,3538398,2110,947,1163,1528.5
motty,FALSE,3537969,2055,1000,1055,1527.5
feaze,FALSE,3537935,2207,1129,1078,1668
abyss,TRUE,3537293.5,2211,393,1818,1302
feeds,FALSE,3537212.5,2251,660,1591,1455.5
navvy,FALSE,3536353,2025,800,1225,1412.5
disci,FALSE,3535719,2083,556,1527,1319.5
amaze,TRUE,3535591,2298,930,1368,1614
duked,FALSE,3533818.5,2085,745,1340,1415
dykey,FALSE,3533043,2045,828,1217,1436.5
cabby,TRUE,3532802,2041,947,1094,1494
agaze,FALSE,3532601,2300,904,1396,1602
sassy,TRUE,3532338.5,1944,1285,659,1614.5
dawds,FALSE,3531907,2091,546,1545,1318.5
kadai,FALSE,3531279,2128,573,1555,1350.5
hurry,TRUE,3530714,2090,934,1156,1512
gloop,FALSE,3530669,1967,748,1219,1357.5
karma,TRUE,3529851,2246,619,1627,1432.5
anata,FALSE,3529784,2126,738,1388,1432
cliff,TRUE,3529719,1950,726,1224,1338
lobby,TRUE,3529400,2005,812,1193,1408.5
check,TRUE,3528979,2085,784,1301,1434.5
aways,FALSE,3527553,2138,531,1607,1334.5
byded,FALSE,3527172.5,2110,707,1403,1408.5
hakas,FALSE,3526784,2108,584,1524,1346
peggy,FALSE,3526449.5,2119,891,1228,1505
slubb,FALSE,3526223,1990,767,1223,1378.5
souks,FALSE,3525843,1950,901,1049,1425.5
paddy,TRUE,3525733,2042,954,1088,1498
venge,FALSE,3525650,2055,924,1131,1489.5
woold,FALSE,3525539,1885,886,999,1385.5
typps,FALSE,3525091,2048,316,1732,1182
every,TRUE,3524636.5,2459,780,1679,1619.5
durry,FALSE,3523979,2081,976,1105,1528.5
zinky,FALSE,3522530,1851,763,1088,1307
niffs,FALSE,3520503,2022,335,1687,1178.5
posho,FALSE,3520406,2016,587,1429,1301.5
blood,TRUE,3519844,1958,868,1090,1413
peize,FALSE,3519839,2084,1094,990,1589
fudgy,FALSE,3519581,1751,837,914,1294
ology,FALSE,3519451,2038,926,1112,1482
banya,FALSE,3519396,2143,683,1460,1413
hoggs,FALSE,3518781.5,1970,527,1443,1248.5
husos,FALSE,3517915,2127,503,1624,1315
flamm,FALSE,3516803,2062,754,1308,1408
fauna,TRUE,3516755,2123,851,1272,1487
uncus,FALSE,3515227,2073,294,1779,1183.5
baccy,FALSE,3515130,2041,1049,992,1545
swish,TRUE,3514406.5,1838,986,852,1412
skegs,FALSE,3514011,2176,665,1511,1420.5
gilly,FALSE,3512870,2012,955,1057,1483.5
kyack,FALSE,3512428.5,1976,615,1361,1295.5
vivda,FALSE,3512100,2075,427,1648,1251
weeds,FALSE,3511887.5,2238,607,1631,1422.5
worry,TRUE,3511747,2121,1041,1080,1581
homos,FALSE,3511657,1968,577,1391,1272.5
sighs,FALSE,3511423,1944,699,1245,1321.5
fifth,TRUE,3510876,1900,641,1259,1270.5
stott,FALSE,3510348,1958,1079,879,1518.5
congo,FALSE,3510125,1971,750,1221,1360.5
coomy,FALSE,3509898,1836,1153,683,1494.5
bromo,FALSE,3509881,2075,810,1265,1442.5
meffs,FALSE,3509681,2179,445,1734,1312
woosh,FALSE,3509492,1864,916,948,1390
dumky,FALSE,3509103,1744,777,967,1260.5
snugs,FALSE,3508495,1925,730,1195,1327.5
fordo,FALSE,3508185,2087,705,1382,1396
dusts,FALSE,3507310,2112,552,1560,1332
boyos,FALSE,3506796,1975,649,1326,1312
chack,FALSE,3506760,1938,914,1024,1426
borgo,FALSE,3506356,2077,749,1328,1413
happy,TRUE,3506333,2051,845,1206,1448
haika,FALSE,3506318,2137,758,1379,1447.5
doxed,FALSE,3504778.5,2136,838,1298,1487
axial,TRUE,3504743,2241,740,1501,1490.5
mossy,TRUE,3504076.5,2006,1001,1005,1503.5
cully,FALSE,3503437,1970,1022,948,1496
immew,FALSE,3503420.5,2195,468,1727,1331.5
ruggy,FALSE,3503173.5,2011,798,1213,1404.5
hoody,FALSE,3502829,1839,1025,814,1432
skegg,FALSE,3502581.5,2176,670,1506,1423
yoofs,FALSE,3502524,1915,600,1315,1257.5
gulls,FALSE,3502236,2023,611,1412,1317
zymic,FALSE,3501748,1845,276,1569,1060.5
sluff,FALSE,3501525,1930,793,1137,1361.5
arars,FALSE,3501265,2364,903,1461,1633.5
dozed,FALSE,3500256.5,2134,837,1297,1485.5
daggy,FALSE,3500088.5,1996,922,1074,1459
whata,FALSE,3499613,2149,737,1412,1443
mohos,FALSE,3499577,1968,563,1405,1265.5
cutup,FALSE,3499043,1918,633,1285,1275.5
poaka,FALSE,3498879,2130,847,1283,1488.5
ginny,FALSE,3498381.5,1914,1002,912,1458
mulls,FALSE,3497964,2021,603,1418,1312
aghas,FALSE,3497353,2206,361,1845,1283.5
scoff,TRUE,3496654,1946,711,1235,1328.5
bevel,TRUE,3496624,2120,938,1182,1529
outdo,TRUE,3496257,2167,465,1702,1316
peeks,FALSE,3495934.5,2222,652,1570,1437
panga,FALSE,3495376,2105,725,1380,1415
wadds,FALSE,3495118,2091,567,1524,1329
fiqhs,FALSE,3494690,1880,403,1477,1141.5
toffy,FALSE,3494136,1964,852,1112,1408
minny,FALSE,3494109.5,1912,994,918,1453
junks,FALSE,3493916,1854,436,1418,1145
groof,FALSE,3493430,2017,784,1233,1400.5
whirr,FALSE,3492972,2057,857,1200,1457
beech,TRUE,3492673.5,2150,883,1267,1516.5
skags,FALSE,3491792,2029,795,1234,1412
kebob,FALSE,3491262,2198,462,1736,1330
firry,FALSE,3491166,2108,1017,1091,1562.5
smews,FALSE,3490386,2166,642,1524,1404
unpin,FALSE,3489292.5,2000,466,1534,1233
blaff,FALSE,3489207,2031,742,1289,1386.5
griff,FALSE,3488791,1991,709,1282,1350
spoom,FALSE,3488772,1935,845,1090,1390
hammy,FALSE,3488592.5,2003,866,1137,1434.5
aguna,FALSE,3488478,2216,564,1652,1390
zilla,FALSE,3488367,2239,543,1696,1391
apayd,FALSE,3487826,2042,630,1412,1336
ovoli,FALSE,3486990,2117,473,1644,1295
socks,FALSE,3486925,1941,792,1149,1366.5
cutty,FALSE,3486902,1989,998,991,1493.5
zimbs,FALSE,3486851,1865,326,1539,1095.5
uvula,FALSE,3486493,2163,439,1724,1301
enemy,TRUE,3486423.5,2321,768,1553,1544.5
janns,FALSE,3486350.5,2104,681,1423,1392.5
dacha,FALSE,3486070,2106,563,1543,1334.5
discs,FALSE,3485684,2083,581,1502,1332
hight,FALSE,3485141,1993,619,1374,1306
rummy,FALSE,3484942.5,2009,784,1225,1396.5
piing,FALSE,3484233,1843,833,1010,1338
thoft,FALSE,3482482,1926,825,1101,1375.5
bonny,FALSE,3481590.5,1907,1137,770,1522
mutts,FALSE,3481429,2040,579,1461,1309.5
swags,FALSE,3481120,2021,829,1192,1425
torot,FALSE,3481030,2177,976,1201,1576.5
furrs,FALSE,3480532,2119,673,1446,1396
evens,FALSE,3480096.5,2373,482,1891,1427.5
kokam,FALSE,3479603,2082,516,1566,1299
botty,FALSE,3479544,2024,1066,958,1545
alway,FALSE,3479288,2168,895,1273,1531.5
nudzh,FALSE,3478222,1791,457,1334,1124
keeps,FALSE,3477321.5,2222,525,1697,1373.5
stuff,TRUE,3476108,1949,669,1280,1309
xoana,FALSE,3475738,2169,832,1337,1500.5
oxeye,FALSE,3474926.5,2183,659,1524,1421
spims,FALSE,3474561,1909,797,1112,1353
fists,FALSE,3474497,2139,593,1546,1366
pomps,FALSE,3473642,1935,568,1367,1251.5
halfa,FALSE,3473489,2143,584,1559,1363.5
vills,FALSE,3473327,2062,555,1507,1308.5
pogos,FALSE,3471353,1937,656,1281,1296.5
muntu,FALSE,3471128,1972,572,1400,1272
kapas,FALSE,3470988,2075,581,1494,1328
moong,FALSE,3470866,1821,853,968,1337
gasps,FALSE,3470614,2173,585,1588,1379
emyde,FALSE,3469883,2141,632,1509,1386.5
knock,TRUE,3469805.5,1873,616,1257,1244.5
casks,FALSE,3469592,2177,673,1504,1425
bakra,FALSE,3469121,2215,705,1510,1460
scuds,FALSE,3469095,1893,676,1217,1284.5
pawas,FALSE,3468628,2067,671,1396,1369
bloop,FALSE,3467972,1934,806,1128,1370
meves,FALSE,3467779,2121,752,1369,1436.5
weeps,FALSE,3467542.5,2214,588,1626,1401
godso,FALSE,3467539,1961,698,1263,1329.5
banda,FALSE,3467107,2096,749,1347,1422.5
pomos,FALSE,3466765,1935,650,1285,1292.5
mooch,FALSE,3466533,1798,921,877,1359.5
wifie,FALSE,3466055,2104,892,1212,1498
veges,FALSE,3466045,2123,706,1417,1414.5
ixias,FALSE,3465944,2211,513,1698,1362
zests,FALSE,3465787,2376,500,1876,1438
quick,TRUE,3464777,1783,740,1043,1261.5
smaak,FALSE,3464656,2027,987,1040,1507
jerry,FALSE,3464476,2337,941,1396,1639
emove,FALSE,3463960,2176,824,1352,1500
hoofs,FALSE,3463726,1877,663,1214,1270
emeer,FALSE,3463325.5,2191,817,1374,1504
knurr,FALSE,3462942,2046,636,1410,1341
remex,FALSE,3462931,2228,734,1494,1481
coffs,FALSE,3462594,1946,573,1373,1259.5
durum,FALSE,3461846,1962,584,1378,1273
waqfs,FALSE,3461057,1957,459,1498,1208
caeca,FALSE,3460243,2413,895,1518,1654
debby,FALSE,3459803,2110,798,1312,1454
simps,FALSE,3459337,1909,715,1194,1312
adaws,FALSE,3459120,2091,529,1562,1310
kists,FALSE,3458951,2134,477,1657,1305.5
missy,TRUE,3458170.5,1980,924,1056,1452
reeve,FALSE,3457377.5,2042,994,1048,1518
cheek,TRUE,3457004.5,2085,950,1135,1517.5
scows,FALSE,3456831,1933,711,1222,1322
phono,FALSE,3456373,1948,770,1178,1359
hooks,FALSE,3456261,1872,683,1189,1277.5
koppa,FALSE,3456059,2130,471,1659,1300.5
senes,FALSE,3455477,2224,1101,1123,1662.5
kalam,FALSE,3455378,2057,641,1416,1349
hobos,FALSE,3454920,1937,573,1364,1255
ummah,FALSE,3454565.5,2043,434,1609,1238.5
sulks,FALSE,3453325,1925,755,1170,1340
foods,FALSE,3452647,1868,764,1104,1316
mixup,FALSE,3452545,1785,459,1326,1122
billy,TRUE,3450173,1979,1013,966,1496
adman,FALSE,3450148,2127,515,1612,1321
reses,FALSE,3449681,2511,781,1730,1646
dooks,FALSE,3449526,1863,725,1138,1294
gaffs,FALSE,3449435,2034,515,1519,1274.5
wists,FALSE,3449172,2126,540,1586,1333
nippy,FALSE,3448042,1960,711,1249,1335.5
pacha,FALSE,3447913,2082,594,1488,1338
jests,FALSE,3447807,2368,517,1851,1442.5
feyed,FALSE,3447060,2050,843,1207,1446.5
halwa,FALSE,3446812,2130,574,1556,1352
cocks,FALSE,3446370,1941,624,1317,1282.5
booms,FALSE,3446000,1856,800,1056,1328
emend,FALSE,3445986.5,2274,587,1687,1430.5
bossy,TRUE,3445651.5,1975,1067,908,1521
gloom,TRUE,3444973,1919,734,1185,1326.5
samba,FALSE,3444880,2092,819,1273,1455.5
abaft,FALSE,3444239,2050,752,1298,1401
asana,FALSE,3442249,2077,710,1367,1393.5
yesks,FALSE,3442126,2293,419,1874,1356
mapau,FALSE,3441889,2010,633,1377,1321.5
patka,FALSE,3441816,2124,676,1448,1400
bohos,FALSE,3441152,1937,629,1308,1283
sicks,FALSE,3441019,1915,715,1200,1315
levee,FALSE,3440950,1853,1121,732,1487
moobs,FALSE,3440367,1856,690,1166,1273
midis,FALSE,3439966,1933,578,1355,1255.5
snubs,FALSE,3439619,1892,678,1214,1285
bulls,FALSE,3439539,1990,669,1321,1329.5
muzak,FALSE,3437614,1901,580,1321,1240.5
tuffs,FALSE,3437596,1949,431,1518,1190
dixie,FALSE,3437447,2110,907,1203,1508.5
booze,TRUE,3437168,2031,1140,891,1585.5
neemb,FALSE,3437152.5,2171,535,1636,1353
dered,FALSE,3436904.5,2263,952,1311,1607.5
tutee,FALSE,3436751,2180,1188,992,1684
wahoo,FALSE,3435340,2155,586,1569,1370.5
mihis,FALSE,3435265,1942,512,1430,1227
dyked,FALSE,3434834.5,2045,582,1463,1313.5
whish,FALSE,3434428,1838,803,1035,1320.5
cacky,FALSE,3434412,1976,977,999,1476.5
azans,FALSE,3434363,2112,668,1444,1390
nebek,FALSE,3434344,2075,767,1308,1421
poyou,FALSE,3433824,1893,583,1310,1238
bitty,TRUE,3433638,1998,989,1009,1493.5
nooky,FALSE,3431918,1842,979,863,1410.5
hunch,TRUE,3431765,1834,685,1149,1259.5
keyed,FALSE,3431514,2045,727,1318,1386
abuna,FALSE,3431354,2183,568,1615,1375.5
skunk,TRUE,3431329.5,1827,836,991,1331.5
sists,FALSE,3431268,1932,823,1109,1377.5
virid,FALSE,3430616,2003,684,1319,1343.5
whoot,FALSE,3429546,1913,856,1057,1384.5
inwit,FALSE,3428661,2058,558,1500,1308
pimps,FALSE,3427736,1909,491,1418,1200
skull,TRUE,3427655,1925,859,1066,1392
woods,FALSE,3427322,1855,711,1144,1283
idiom,TRUE,3426932,1988,494,1494,1241
kabob,FALSE,3426744,2051,524,1527,1287.5
deevs,FALSE,3426652.5,2193,612,1581,1402.5
brook,TRUE,3426554,1979,929,1050,1454
ebook,FALSE,3425384,2198,577,1621,1387.5
bunns,FALSE,3425050.5,1892,716,1176,1304
scups,FALSE,3424750,1869,657,1212,1263
salsa,TRUE,3424665.5,2175,1017,1158,1596
smush,FALSE,3424022.5,1752,879,873,1315.5
pulpy,TRUE,3423947,1868,854,1014,1361
sexed,FALSE,3423894,2081,1056,1025,1568.5
gemmy,FALSE,3423751.5,2071,850,1221,1460.5
butts,FALSE,3423004,2009,645,1364,1327
bimbo,FALSE,3422575,1885,518,1367,1201.5
tetes,FALSE,3421388,2341,856,1485,1598.5
smogs,FALSE,3420866,1889,760,1129,1324.5
lisks,FALSE,3420284,2115,461,1654,1288
fleek,FALSE,3419579.5,2113,945,1168,1529
poofs,FALSE,3418834,1844,736,1108,1290
seels,FALSE,3418685.5,2322,983,1339,1652.5
brava,FALSE,3418560,2162,857,1305,1509.5
fugue,TRUE,3418276,2020,895,1125,1457.5
icing,TRUE,3417567,1945,563,1382,1254
kutus,FALSE,3415777,1944,435,1509,1189.5
rajah,TRUE,3415744,2152,714,1438,1433
gippo,FALSE,3414064,1966,483,1483,1224.5
boong,FALSE,3412441,1790,919,871,1354.5
sells,FALSE,3412397,2322,918,1404,1620
swabs,FALSE,3412244,1988,777,1211,1382.5
quell,TRUE,3411676,2190,704,1486,1447
geeks,FALSE,3411467.5,2176,625,1551,1400.5
pooks,FALSE,3411369,1839,756,1083,1297.5
widow,TRUE,3411348,1884,509,1375,1196.5
kippa,FALSE,3410153,2104,394,1710,1249
chaff,TRUE,3409566,1943,710,1233,1326.5
weete,FALSE,3409254.5,1917,1065,852,1491
socko,FALSE,3409063,1941,814,1127,1377.5
peece,FALSE,3407609.5,1850,1137,713,1493.5
manga,TRUE,3406637,2057,690,1367,1373.5
becke,FALSE,3405312,1973,950,1023,1461.5
imido,FALSE,3404087,1988,465,1523,1226.5
flood,TRUE,3402778,1898,831,1067,1364.5
kalpa,FALSE,3402519,2105,550,1555,1327.5
kasha,FALSE,3401555,2108,496,1612,1302
kicks,FALSE,3401527.5,1915,369,1546,1142
gurry,FALSE,3401355,2011,980,1031,1495.5
vughy,FALSE,3401245,1702,688,1014,1195
wigga,FALSE,3400864.5,2050,492,1558,1271
whump,FALSE,3399777,1674,516,1158,1095
drere,FALSE,3399525.5,2263,1131,1132,1697
pixie,TRUE,3399290,2086,938,1148,1512
rubby,FALSE,3398370,1978,736,1242,1357
bombs,FALSE,3397443,1856,573,1283,1214.5
yexes,FALSE,3397160,2128,614,1514,1371
murry,FALSE,3397083,2009,972,1037,1490.5
dreed,FALSE,3396910,2263,991,1272,1627
hoghs,FALSE,3396787,1970,479,1491,1224.5
desks,FALSE,3396593,2246,524,1722,1385
setts,FALSE,3395862,2341,894,1447,1617.5
kieve,FALSE,3393656.5,2054,869,1185,1461.5
luffs,FALSE,3390694,1930,370,1560,1150
coppy,FALSE,3390133,1884,949,935,1416.5
nobby,FALSE,3389635,1907,761,1146,1334
forgo,TRUE,3389290,2017,712,1305,1364.5
grege,FALSE,3388890,2193,1059,1134,1626
kamas,FALSE,3388533,2027,584,1443,1305.5
weems,FALSE,3388174.5,2166,606,1560,1386
feese,FALSE,3387154.5,1881,1150,731,1515.5
baffs,FALSE,3386738,2001,573,1428,1287
sijos,FALSE,3386066,1965,739,1226,1352
gusts,FALSE,3384686,2042,556,1486,1299
musos,FALSE,3384284,2046,541,1505,1293.5
zoons,FALSE,3383838,1876,744,1132,1310
endew,FALSE,3383078,2170,569,1601,1369.5
woops,FALSE,3382977,1831,692,1139,1261.5
shook,TRUE,3382762,1872,999,873,1435.5
bloom,TRUE,3382276,1886,792,1094,1339
bidis,FALSE,3381541,1902,644,1258,1273
jocky,FALSE,3380945,1767,774,993,1270.5
whows,FALSE,3380733,1864,532,1332,1198
musts,FALSE,3380414,2040,548,1492,1294
folly,TRUE,3379013,1945,1053,892,1499
baddy,FALSE,3378569,1963,985,978,1474
civil,TRUE,3377508,1892,763,1129,1327.5
skeef,FALSE,3377407.5,2083,897,1186,1490
outgo,TRUE,3377362,2097,472,1625,1284.5
vagal,FALSE,3377217,2006,733,1273,1369.5
gappy,FALSE,3376974,1972,891,1081,1431.5
agmas,FALSE,3375802,2125,413,1712,1269
mahua,FALSE,3374164,2043,566,1477,1304.5
veeps,FALSE,3374147.5,2169,548,1621,1358.5
desex,FALSE,3373647,2081,759,1322,1420
goody,TRUE,3373470,1760,1071,689,1415.5
paska,FALSE,3372670,2075,645,1430,1360
hully,FALSE,3372655,1901,893,1008,1397
commy,FALSE,3372392.5,1836,970,866,1403
doomy,FALSE,3372381,1758,1066,692,1412
dreer,FALSE,3372234.5,2263,1085,1178,1674
shows,FALSE,3371679,1864,815,1049,1339.5
spazz,FALSE,3370189,1908,758,1150,1333
piccy,FALSE,3369406,1858,916,942,1387
hewed,FALSE,3369306,1999,773,1226,1386
moody,TRUE,3369198,1758,1063,695,1410.5
asway,FALSE,3367603,2138,710,1428,1424
kibei,FALSE,3367566,2172,608,1564,1390
dully,TRUE,3365920,1892,935,957,1413.5
vroom,FALSE,3365703,1957,728,1229,1342.5
mondo,FALSE,3364607,1891,652,1239,1271.5
eases,FALSE,3364554,2583,810,1773,1696.5
mezzo,FALSE,3364535,2062,438,1624,1250
dsomo,FALSE,3364304,1959,497,1462,1228
kevel,FALSE,3364012,2055,785,1270,1420
tatty,TRUE,3363406,1993,1067,926,1530
bunjy,FALSE,3363053,1718,864,854,1291
reded,FALSE,3362268.5,2263,858,1405,1560.5
dibbs,FALSE,3361337,1902,430,1472,1166
nying,FALSE,3360788.5,1914,549,1365,1231.5
keech,FALSE,3360061.5,2085,730,1355,1407.5
abask,FALSE,3359971,1996,748,1248,1372
thymy,FALSE,3359922,1761,754,1007,1257.5
gammy,FALSE,3359233.5,1924,912,1012,1418
halva,FALSE,3358585,2085,595,1490,1340
amiga,FALSE,3358522,2154,585,1569,1369.5
hexes,FALSE,3358362,2090,677,1413,1383.5
queen,TRUE,3357915.5,2092,834,1258,1463
hough,FALSE,3356768,1809,728,1081,1268.5
snees,FALSE,3356306.5,2224,984,1240,1604
beefs,FALSE,3356235.5,2148,663,1485,1405.5
mafia,TRUE,3354598,2061,658,1403,1359.5
plook,FALSE,3354505,1869,832,1037,1350.5
wolly,FALSE,3353688,1932,1000,932,1466
jimpy,FALSE,3353357,1735,697,1038,1216
buffe,FALSE,3352050,1987,843,1144,1415
dexes,FALSE,3351627,2081,719,1362,1400
dunny,FALSE,3351431.5,1794,982,812,1388
highs,FALSE,3350881,1944,402,1542,1173
alaap,FALSE,3350837,1903,868,1035,1385.5
arras,FALSE,3350688,2364,770,1594,1567
exode,FALSE,3350569,2136,823,1313,1479.5
scugs,FALSE,3350200,1823,683,1140,1253
jacal,FALSE,3350098,2032,699,1333,1365.5
feebs,FALSE,3349441.5,2148,615,1533,1381.5
fehme,FALSE,3348747,1940,879,1061,1409.5
gazar,FALSE,3348271,2081,805,1276,1443
soots,FALSE,3347780,1958,1064,894,1511
tufts,FALSE,3347610,1949,535,1414,1242
tummy,FALSE,3347394.5,1839,828,1011,1333.5
scums,FALSE,3345382,1821,675,1146,1248
zowee,FALSE,3345223,1958,1050,908,1504
oozed,FALSE,3344729,2134,767,1367,1450.5
ciggy,FALSE,3344717.5,1812,907,905,1359.5
cusum,FALSE,3344201,1821,588,1233,1204.5
cluck,TRUE,3343657,1755,829,926,1292
modii,FALSE,3343072,1988,630,1358,1309
jumps,FALSE,3342723,1746,353,1393,1049.5
kedge,FALSE,3342720,1928,837,1091,1382.5
snuff,TRUE,3342493,1832,679,1153,1255.5
squiz,FALSE,3341060,1786,698,1088,1242
sunks,FALSE,3340956,1827,782,1045,1304.5
mumsy,FALSE,3340308,1790,889,901,1339.5
hajji,FALSE,3340030,1962,389,1573,1175.5
miggs,FALSE,3339244.5,1863,488,1375,1175.5
hasks,FALSE,3338810,2108,544,1564,1326
burry,FALSE,3338658,1978,1038,940,1508
bosom,TRUE,3337984,1856,706,1150,1281
ficin,FALSE,3336720,1852,682,1170,1267
allyl,FALSE,3336700.5,1974,613,1361,1293.5
pavan,FALSE,3336072,1954,788,1166,1371
buxom,TRUE,3335472,1732,545,1187,1138.5
rusks,FALSE,3335160,2114,462,1652,1288
pongo,FALSE,3334451,1869,694,1175,1281.5
goofs,FALSE,3334367,1798,709,1089,1253.5
sools,FALSE,3334120,1939,1087,852,1513
filly,TRUE,3333107,1919,976,943,1447.5
imids,FALSE,3333049,1933,443,1490,1188
wedge,TRUE,3332941,1920,900,1020,1410
siris,FALSE,3332592,2102,925,1177,1513.5
mugga,FALSE,3332106.5,1964,500,1464,1232
orzos,FALSE,3330928,2163,487,1676,1325
goopy,FALSE,3329125,1736,1052,684,1394
voulu,FALSE,3328635,1927,650,1277,1288.5
skids,FALSE,3328361,1837,747,1090,1292
cooky,FALSE,3328103,1740,1140,600,1440
pully,FALSE,3327763,1868,966,902,1417
kusso,FALSE,3327537.5,1950,515,1435,1232.5
gooks,FALSE,3326902,1793,729,1064,1261
gobos,FALSE,3325561,1858,619,1239,1238.5
doffs,FALSE,3325077,1868,486,1382,1177
gamay,FALSE,3324902,1924,1007,917,1465.5
aboma,FALSE,3322790,2147,533,1614,1340
mooks,FALSE,3322630,1791,721,1070,1256
hypha,FALSE,3322626,2051,242,1809,1146.5
fulls,FALSE,3322473,1930,632,1298,1281
hussy,TRUE,3322227.5,1871,870,1001,1370.5
busts,FALSE,3321989,2009,614,1395,1311.5
shash,FALSE,3319570.5,1906,1127,779,1516.5
bevue,FALSE,3319523,1929,970,959,1449.5
myopy,FALSE,3318669,1734,788,946,1261
finny,FALSE,3318618.5,1821,1023,798,1422
gumma,FALSE,3318147.5,1964,494,1470,1229
lowly,TRUE,3318087,1932,919,1013,1425.5
spoof,TRUE,3318016,1844,829,1015,1336.5
zitis,FALSE,3317516,1967,510,1457,1238.5
mythy,FALSE,3317357,1761,633,1128,1197
ilial,FALSE,3315904.5,2204,820,1384,1512
excel,TRUE,3315733,2189,616,1573,1402.5
spuds,FALSE,3315018,1791,697,1094,1244
baggy,TRUE,3314767.5,1893,984,909,1438.5
lolls,FALSE,3314569,1939,677,1262,1308
salal,FALSE,3314094,2175,1101,1074,1638
spook,TRUE,3313837,1839,916,923,1377.5
spiff,FALSE,3313377,1818,754,1064,1286
punny,FALSE,3313274.5,1770,1013,757,1391.5
malwa,FALSE,3313181,2049,612,1437,1330.5
daffy,FALSE,3313119,1903,839,1064,1371
jeely,FALSE,3312705.5,2148,965,1183,1556.5
sansa,FALSE,3312296.5,2077,1044,1033,1560.5
kinky,TRUE,3312098.5,1816,780,1036,1298
putty,TRUE,3311228,1887,942,945,1414.5
etwee,FALSE,3311153,1917,917,1000,1417
boody,FALSE,3310773,1727,1129,598,1428
stets,FALSE,3310155,2341,795,1546,1568
cohog,FALSE,3309411,1800,659,1141,1229.5
cubic,TRUE,3309162.5,1819,630,1189,1224.5
skews,FALSE,3308186,2070,614,1456,1342
willy,TRUE,3307782,1906,923,983,1414.5
byssi,FALSE,3306621.5,1949,458,1491,1203.5
jelly,TRUE,3306417,2148,900,1248,1524
sowps,FALSE,3305562,1831,757,1074,1294
mucus,TRUE,3304250,1821,467,1354,1144
choom,FALSE,3302635,1798,760,1038,1279
swops,FALSE,3302544,1831,740,1091,1285.5
gobbi,FALSE,3301113,1887,486,1401,1186.5
kitty,TRUE,3301026,1933,836,1097,1384.5
bacha,FALSE,3300749,2003,625,1378,1314
pooja,FALSE,3300720,1955,731,1224,1343
banak,FALSE,3300686,1928,892,1036,1410
lummy,FALSE,3300492.5,1820,767,1053,1293.5
dsobo,FALSE,3300246,1928,453,1475,1190.5
spifs,FALSE,3300231,1818,764,1054,1291
busby,FALSE,3299286,1759,827,932,1293
usque,FALSE,3298302,2160,556,1604,1358
sesey,FALSE,3297778,2091,1370,721,1730.5
khaph,FALSE,3297424,1836,660,1176,1248
wulls,FALSE,3297148,1917,579,1338,1248
yummo,FALSE,3294906.5,1845,379,1466,1112
rotor,TRUE,3294400,2177,839,1338,1508
hushy,FALSE,3294042,1871,727,1144,1299
swoop,TRUE,3293883,1831,842,989,1336.5
euked,FALSE,3293793,2085,706,1379,1395.5
spiks,FALSE,3292766,1813,784,1029,1298.5
jenny,FALSE,3291928.5,2050,947,1103,1498.5
erses,FALSE,3291856,2511,773,1738,1642
cesse,FALSE,3291694.5,2122,1115,1007,1618.5
witty,TRUE,3291247,1925,899,1026,1412
jetty,TRUE,3289882,2167,876,1291,1521.5
araba,FALSE,3288069,2013,803,1210,1408
stats,FALSE,3287936,2194,925,1269,1559.5
pizza,TRUE,3287266,1937,439,1498,1188
ataxy,FALSE,3286865,2030,892,1138,1461
vigia,FALSE,3286527,2005,534,1471,1269.5
ettle,FALSE,3286414,2371,846,1525,1608.5
skaws,FALSE,3285967,1923,744,1179,1333.5
cobby,FALSE,3285820,1805,922,883,1363.5
bazar,FALSE,3285574,2048,863,1185,1455.5
evoke,TRUE,3285197,2080,810,1270,1445
dowds,FALSE,3284925,1855,521,1334,1188
skips,FALSE,3284016,1813,728,1085,1270.5
kiddo,FALSE,3283047,1892,424,1468,1158
biggs,FALSE,3280819.5,1832,554,1278,1193
ninja,TRUE,3279851,2133,444,1689,1288.5
diffs,FALSE,3279171,1842,409,1433,1125.5
poddy,FALSE,3278751,1806,929,877,1367.5
amban,FALSE,3277707,2024,529,1495,1276.5
pussy,FALSE,3277335.5,1838,943,895,1390.5
pudus,FALSE,3276396,1791,521,1270,1156
gnawn,FALSE,3276100.5,1953,664,1289,1308.5
juror,TRUE,3275936,1994,713,1281,1353.5
dukka,FALSE,3274608.5,1938,428,1510,1183
gabby,FALSE,3272661,1893,864,1029,1378.5
naans,FALSE,3271591.5,2077,866,1211,1471.5
gungy,FALSE,3271130.5,1724,880,844,1302
howso,FALSE,3270965,1864,603,1261,1233.5
jumbo,TRUE,3270335,1722,349,1373,1035.5
gliff,FALSE,3269578,1802,643,1159,1222.5
lills,FALSE,3268663,1913,600,1313,1256.5
kissy,FALSE,3267133.5,1884,837,1047,1360.5
briki,FALSE,3266223,1953,772,1181,1362.5
wasps,FALSE,3265526,2067,553,1514,1310
leses,FALSE,3265231,2322,764,1558,1543
jaaps,FALSE,3264982,1900,717,1183,1308.5
plump,TRUE,3264831,1749,632,1117,1190.5
books,FALSE,3264205,1760,787,973,1273.5
attar,FALSE,3263877,2413,704,1709,1558.5
wokka,FALSE,3262376.5,1978,493,1485,1235.5
niffy,FALSE,3261563,1821,663,1158,1242
faddy,FALSE,3261503,1903,948,955,1425.5
tubby,FALSE,3260822,1808,780,1028,1294
zooty,FALSE,3259780,1792,1029,763,1410.5
hoppy,FALSE,3259351,1815,820,995,1317.5
enmew,FALSE,3256826,2098,555,1543,1326.5
myrrh,TRUE,3254445,1931,584,1347,1257.5
whoso,FALSE,3254275,1864,700,1164,1282
shivs,FALSE,3254252,1793,858,935,1325.5
jolls,FALSE,3253857,1966,609,1357,1287.5
chock,TRUE,3253634,1702,851,851,1276.5
doggy,FALSE,3253106.5,1760,897,863,1328.5
dohyo,FALSE,3252987,1839,460,1379,1149.5
weedy,TRUE,3252947.5,2037,935,1102,1486
wheep,FALSE,3252406.5,1975,778,1197,1376.5
epees,FALSE,3251150.5,2020,664,1356,1342
nuffs,FALSE,3250929,1832,319,1513,1075.5
eques,FALSE,3249187,2160,596,1564,1378
bezel,TRUE,3249054,2006,900,1106,1453
coomb,FALSE,3248772,1686,800,886,1243
mongo,FALSE,3245712,1821,659,1162,1240
waffs,FALSE,3244347,1928,483,1445,1205.5
femmy,FALSE,3243988.5,1978,871,1107,1424.5
begem,FALSE,3243951,1921,842,1079,1381.5
gully,TRUE,3243296,1822,939,883,1380.5
nuddy,FALSE,3242760,1794,731,1063,1262.5
sughs,FALSE,3241849,1754,683,1071,1218.5
gypsy,TRUE,3240286,1681,731,950,1206
sissy,TRUE,3239450.5,1682,1183,499,1432.5
dodgy,TRUE,3238858,1760,905,855,1332.5
skogs,FALSE,3238666,1793,732,1061,1262.5
rebbe,FALSE,3237055,2160,852,1308,1506
pukka,FALSE,3236451.5,1914,459,1455,1186.5
waddy,FALSE,3236178,1890,895,995,1392.5
mewed,FALSE,3235675,1918,811,1107,1364.5
nenes,FALSE,3235447,2224,772,1452,1498
iambi,FALSE,3235111,2121,434,1687,1277.5
junky,FALSE,3234976,1653,764,889,1208.5
puffa,FALSE,3233876,1919,452,1467,1185.5
laxly,FALSE,3233813,2011,930,1081,1470.5
tizzy,FALSE,3232046,1766,746,1020,1256
ninon,FALSE,3231694,1870,640,1230,1255
vanda,FALSE,3231321,1978,619,1359,1298.5
fanga,FALSE,3231146,1966,719,1247,1342.5
vexer,FALSE,3230408,2079,827,1252,1453
weize,FALSE,3230284,1932,1035,897,1483.5
deled,FALSE,3230204.5,2074,901,1173,1487.5
vehme,FALSE,3230027,1882,786,1096,1334
bivia,FALSE,3229836,1972,646,1326,1309
gunny,FALSE,3228807.5,1724,986,738,1355
nawab,FALSE,3228051,1920,541,1379,1230.5
janny,FALSE,3227410.5,1903,1009,894,1456
unwon,FALSE,3227176.5,1874,408,1466,1141
exome,FALSE,3226856,2064,822,1242,1443
gutty,FALSE,3226761,1841,915,926,1378
jebel,FALSE,3226614,1998,793,1205,1395.5
quass,FALSE,3226213.5,2013,723,1290,1368
sowms,FALSE,3226194,1783,775,1008,1279
zills,FALSE,3225931,1948,515,1433,1231.5
subby,FALSE,3225402,1759,997,762,1378
malva,FALSE,3224954,2004,633,1371,1318.5
chick,TRUE,3224434,1676,873,803,1274.5
keefs,FALSE,3223623.5,2083,510,1573,1296.5
yacka,FALSE,3222942,1976,485,1491,1230.5
biccy,FALSE,3222242,1779,947,832,1363
furry,TRUE,3221592,1918,1001,917,1459.5
syphs,FALSE,3220732,1760,511,1249,1135.5
mezes,FALSE,3220209,2007,714,1293,1360.5
emcee,TRUE,3219979,1802,908,894,1355
cuffo,FALSE,3218152,1785,502,1283,1143.5
nanny,TRUE,3217128,1876,1026,850,1451
convo,FALSE,3216073,1820,720,1100,1270
pikis,FALSE,3216036,1813,550,1263,1181.5
kanga,FALSE,3215600,1961,603,1358,1282
cocci,FALSE,3214837,1768,696,1072,1232
brere,FALSE,3214204.5,2160,1193,967,1676.5
livid,TRUE,3213506,1814,615,1199,1214.5
hippy,TRUE,3213445,1789,743,1046,1266
nohow,FALSE,3212590,1796,474,1322,1135
alapa,FALSE,3212282,1903,763,1140,1333
mucic,FALSE,3211774.5,1850,538,1312,1194
vinic,FALSE,3211504,1794,573,1221,1183.5
weepy,FALSE,3208602.5,2013,916,1097,1464.5
merer,FALSE,3208477,2191,1042,1149,1616.5
jills,FALSE,3207951,1940,532,1408,1236
dhaba,FALSE,3207365,1925,650,1275,1287.5
blook,FALSE,3207341,1790,863,927,1326.5
dippy,FALSE,3206710,1780,785,995,1282.5
weeks,FALSE,3206379.5,2070,593,1477,1331.5
gruff,TRUE,3205535,1801,608,1193,1204.5
duomo,FALSE,3205438,1798,667,1131,1232.5
masks,FALSE,3205179,2027,582,1445,1304.5
fusts,FALSE,3204923,1949,577,1372,1263
tanna,FALSE,3204891.5,2126,838,1288,1482
skims,FALSE,3204648,1765,746,1019,1255.5
padma,FALSE,3204454,1923,653,1270,1288
dawah,FALSE,3204191,1852,743,1109,1297.5
toots,FALSE,3203710,1958,847,1111,1402.5
mofos,FALSE,3203409,1796,579,1217,1187.5
goffs,FALSE,3202453,1798,490,1308,1144
ooses,FALSE,3202070,2347,754,1593,1550.5
vacua,FALSE,3201247,1963,549,1414,1256
kvell,FALSE,3200942,2055,530,1525,1292.5
duded,FALSE,3199775,1883,808,1075,1345.5
swigs,FALSE,3198794,1759,788,971,1273.5
faggy,FALSE,3197701.5,1833,947,886,1390
tusks,FALSE,3197612,1944,506,1438,1225
grrrl,FALSE,3197556,1785,853,932,1319
hooky,FALSE,3197321,1671,1011,660,1341
pommy,FALSE,3196718.5,1734,914,820,1324
spugs,FALSE,3196123,1721,704,1017,1212.5
didie,FALSE,3196046,2073,970,1103,1521.5
pappi,FALSE,3195400,1902,565,1337,1233.5
eject,TRUE,3195120.5,2198,656,1542,1427
humus,TRUE,3195036,1752,434,1318,1093
poppa,FALSE,3194360,1928,593,1335,1260.5
swims,FALSE,3193976,1757,780,977,1268.5
foody,FALSE,3193707,1667,1092,575,1379.5
jinns,FALSE,3193462.5,1842,579,1263,1210.5
gussy,FALSE,3192868.5,1792,916,876,1354
wakas,FALSE,3192337,1923,598,1325,1260.5
boogy,FALSE,3191878,1657,1136,521,1396.5
mokos,FALSE,3191609,1791,566,1225,1178.5
which,TRUE,3190653,1668,784,884,1226
solos,FALSE,3190204,1939,925,1014,1432
sumps,FALSE,3189763,1719,699,1020,1209
kilim,FALSE,3189522,1795,534,1261,1164.5
kawas,FALSE,3188852,1923,549,1374,1236
mussy,FALSE,3188596.5,1790,908,882,1349
kaval,FALSE,3187914,1908,692,1216,1300
cocky,FALSE,3187430,1740,952,788,1346
bongo,TRUE,3187287,1790,725,1065,1257.5
boomy,FALSE,3187060,1655,1128,527,1391.5
breer,FALSE,3186913.5,2160,1147,1013,1653.5
hewgh,FALSE,3186824,1929,552,1377,1240.5
wasms,FALSE,3186158,2019,571,1448,1295
donko,FALSE,3185995,1795,642,1153,1218.5
gooby,FALSE,3185699,1657,1026,631,1341.5
cwtch,FALSE,3185535,1688,644,1044,1166
spivs,FALSE,3185327,1760,775,985,1267.5
maxim,TRUE,3185006.5,1891,623,1268,1257
wowee,FALSE,3184397.5,1923,1130,793,1526.5
scuff,FALSE,3184198,1730,632,1098,1181
wynns,FALSE,3183675.5,1779,463,1316,1121
fiscs,FALSE,3183297,1920,606,1314,1263
jewie,FALSE,3183171,1924,870,1054,1397
feoff,FALSE,3182432,1936,683,1253,1309.5
zooid,FALSE,3182258,1725,802,923,1263.5
bully,TRUE,3180599,1789,997,792,1393
impis,FALSE,3176452,1909,324,1585,1116.5
mujik,FALSE,3176204,1631,567,1064,1099
hikoi,FALSE,3174844,1901,426,1475,1163.5
bevvy,FALSE,3174218,1889,874,1015,1381.5
kondo,FALSE,3173570,1795,565,1230,1180
jalap,FALSE,3172524,1930,655,1275,1292.5
compo,FALSE,3172319,1765,646,1119,1205.5
thete,FALSE,3171710.5,2102,1033,1069,1567.5
sucks,FALSE,3171445,1725,699,1026,1212
braza,FALSE,3171188,2048,831,1217,1439.5
mumps,FALSE,3170139,1719,440,1279,1079.5
byway,FALSE,3169922,1787,749,1038,1268
sedes,FALSE,3169373,2044,1037,1007,1540.5
piggy,TRUE,3169043.5,1710,851,859,1280.5
tassa,FALSE,3168952.5,2194,768,1426,1481
woody,TRUE,3168382,1654,1039,615,1346.5
cusps,FALSE,3168293,1869,550,1319,1209.5
bedew,FALSE,3168280,1887,825,1062,1356
kacha,FALSE,3168137,1938,472,1466,1205
macaw,TRUE,3167200,1849,647,1202,1248
whiss,FALSE,3166214.5,1838,700,1138,1269
bunny,TRUE,3166110.5,1691,1044,647,1367.5
gonof,FALSE,3166018,1730,691,1039,1210.5
biffo,FALSE,3164888,1794,493,1301,1143.5
butty,FALSE,3164064,1808,973,835,1390.5
erred,FALSE,3163540,2263,938,1325,1600.5
gogga,FALSE,3163221,1882,601,1281,1241.5
verve,TRUE,3162953,2042,918,1124,1480
dubbo,FALSE,3162801,1767,436,1331,1101.5
bezes,FALSE,3161784,1976,780,1196,1378
nummy,FALSE,3160727.5,1722,716,1006,1219
houff,FALSE,3160610,1716,574,1142,1145
poofy,FALSE,3159894,1643,1064,579,1353.5
swobs,FALSE,3159118,1752,714,1038,1233
jagra,FALSE,3158964,2073,607,1466,1340
fatwa,FALSE,3158374,1977,640,1337,1308.5
pumps,FALSE,3158162,1719,475,1244,1097
gibli,FALSE,3157635,1862,547,1315,1204.5
bwana,FALSE,3157612,1920,770,1150,1345
legge,FALSE,3157408.5,2004,897,1107,1450.5
ghyll,FALSE,3156722,1744,606,1138,1175
expel,TRUE,3155343,2087,618,1469,1352.5
jesus,FALSE,3155055,2158,460,1698,1309
hobby,TRUE,3155038,1736,793,943,1264.5
desse,FALSE,3154177.5,2044,1028,1016,1536
bumbo,FALSE,3153001,1695,502,1193,1098.5
divis,FALSE,3152721,1784,556,1228,1170
geeky,TRUE,3152527.5,1975,953,1022,1464
miffs,FALSE,3152275,1770,405,1365,1087.5
penne,TRUE,3151959.5,1952,1129,823,1540.5
poboy,FALSE,3151088,1703,974,729,1338.5
tests,FALSE,3150777,2341,646,1695,1493.5
lusks,FALSE,3150710,1925,445,1480,1185
aalii,FALSE,3149120,2204,726,1478,1465
giddy,TRUE,3148378,1734,825,909,1279.5
dobby,FALSE,3148303,1727,835,892,1281
kipps,FALSE,3147717,1813,366,1447,1089.5
ovoid,TRUE,3147694,1839,576,1263,1207.5
meved,FALSE,3147467,1873,834,1039,1353.5
cuffs,FALSE,3147114,1730,480,1250,1105
basks,FALSE,3146754,1996,648,1348,1322
bindi,FALSE,3145502,1834,594,1240,1214
middy,FALSE,3144106,1732,817,915,1274.5
kicky,FALSE,3142587.5,1714,697,1017,1205.5
cacao,TRUE,3140351,2030,779,1251,1404.5
yucch,FALSE,3139868,1701,539,1162,1120
boffs,FALSE,3139756,1765,548,1217,1156.5
civvy,FALSE,3139650,1661,859,802,1260
lemme,FALSE,3139177.5,2002,883,1119,1442.5
cuddy,FALSE,3138945,1692,892,800,1292
mzees,FALSE,3137688.5,2007,640,1367,1323.5
zaida,FALSE,3136588,1961,706,1255,1333.5
quoll,FALSE,3136331,1807,771,1036,1289
momma,FALSE,3136199,1880,579,1301,1229.5
gazal,FALSE,3135653,1892,749,1143,1320.5
judgy,FALSE,3135485,1571,721,850,1146
sojus,FALSE,3135350,1775,766,1009,1270.5
embed,TRUE,3134907,1991,603,1388,1297
hazan,FALSE,3133394,1873,677,1196,1275
bokos,FALSE,3133184,1760,632,1128,1196
ibrik,FALSE,3132493,1953,484,1469,1218.5
webby,FALSE,3132091,1934,770,1164,1352
choof,FALSE,3131879,1707,744,963,1225.5
kobos,FALSE,3130252,1760,524,1236,1142
cocoa,TRUE,3130205,2030,729,1301,1379.5
khaya,FALSE,3129492,1907,538,1369,1222.5
woofs,FALSE,3129279,1692,677,1015,1184.5
fucus,FALSE,3128759,1730,496,1234,1113
baffy,FALSE,3127798,1800,901,899,1350.5
chook,FALSE,3127700,1702,831,871,1266.5
smoko,FALSE,3127656,1791,761,1030,1276
jhala,FALSE,3127182,1963,697,1266,1330
moggy,FALSE,3126210.5,1688,893,795,1290.5
moppy,FALSE,3125720,1734,858,876,1296
afara,FALSE,3125299,1953,672,1281,1312.5
woopy,FALSE,3124037,1630,1020,610,1325
galax,FALSE,3123387,1894,702,1192,1298
aurar,FALSE,3120167,2203,865,1338,1534
malax,FALSE,3119115,1892,694,1198,1293
totty,FALSE,3116424,1757,1042,715,1399.5
aback,TRUE,3116196,1826,729,1097,1277.5
favas,FALSE,3116190,1883,688,1195,1285.5
aquas,FALSE,3116023,2013,510,1503,1261.5
pouff,FALSE,3115718,1683,647,1036,1165
zabra,FALSE,3115619,2048,580,1468,1314
vozhd,FALSE,3115306,1606,479,1127,1042.5
hokku,FALSE,3114251.5,1711,416,1295,1063.5
luvvy,FALSE,3113656,1671,733,938,1202
abamp,FALSE,3112125,1820,588,1232,1204
limbi,FALSE,3111793,1860,386,1474,1123
vigil,TRUE,3111361,1744,626,1118,1185
pewee,FALSE,3109904,1596,1152,444,1374
jeeps,FALSE,3108771.5,2047,525,1522,1286
smugs,FALSE,3108410,1673,681,992,1177
quill,TRUE,3107131,1781,793,988,1287
zoppa,FALSE,3105489,1963,454,1509,1208.5
bajra,FALSE,3101863,2040,696,1344,1368
kavas,FALSE,3100644,1878,572,1306,1225
plaza,TRUE,3099139,1938,734,1204,1336
vakas,FALSE,3098942,1878,558,1320,1218
sadza,FALSE,3098584,1932,829,1103,1380.5
gisms,FALSE,3098358,1863,501,1362,1182
beefy,TRUE,3097295.5,1947,991,956,1469
avgas,FALSE,3097178,1976,422,1554,1199
frere,FALSE,3097138.5,2100,1156,944,1628
panax,FALSE,3095485,1842,756,1086,1299
biffs,FALSE,3093850,1739,471,1268,1105
fabby,FALSE,3092898,1800,885,915,1342.5
array,TRUE,3091748,2163,1098,1065,1630.5
tufty,FALSE,3088670,1748,863,885,1305.5
buffa,FALSE,3086712,1840,483,1357,1161.5
biddy,TRUE,3085681,1701,883,818,1292
gippy,FALSE,3084086,1710,789,921,1249.5
jumpy,TRUE,3083783,1545,681,864,1113
jewel,TRUE,3083670,1925,762,1163,1343.5
execs,FALSE,3083642.5,2159,451,1708,1305
frizz,FALSE,3083514,1726,693,1033,1209.5
dweeb,FALSE,3082726.5,1887,661,1226,1274
flava,FALSE,3082281,1913,754,1159,1333.5
opepe,FALSE,3079712,2075,753,1322,1414
flaff,FALSE,3079129,1764,705,1059,1234.5
kloof,FALSE,3078908,1730,623,1107,1176.5
kotow,FALSE,3077183,1736,559,1177,1147.5
yexed,FALSE,3076848,1880,696,1184,1288
radar,TRUE,3076787,2116,859,1257,1487.5
tutti,FALSE,3076378,1771,596,1175,1183.5
goofy,TRUE,3075427,1597,1037,560,1317
cuppy,FALSE,3074653,1668,856,812,1262
nubby,FALSE,3074155,1691,668,1023,1179.5
wauff,FALSE,3073145,1767,613,1154,1190
skoff,FALSE,3072664,1700,681,1019,1190.5
jaggs,FALSE,3072545.5,1854,503,1351,1178.5
gummi,FALSE,3072205.5,1702,441,1261,1071.5
pluff,FALSE,3070789,1658,569,1089,1113.5
titty,FALSE,3070518,1731,965,766,1348
freer,TRUE,3069847.5,2100,1110,990,1605
muggs,FALSE,3069670.5,1673,472,1201,1072.5
cacas,FALSE,3069313,1975,757,1218,1366
hakam,FALSE,3068904,1788,590,1198,1189
annat,FALSE,3068813,2126,783,1343,1454.5
gooky,FALSE,3067962,1592,1057,535,1324.5
boggy,FALSE,3067785.5,1657,959,698,1308
boppy,FALSE,3067295,1703,924,779,1313.5
sowff,FALSE,3065010,1692,732,960,1212
bubbe,FALSE,3064552,1780,864,916,1322
fully,TRUE,3063533,1729,960,769,1344.5
huzza,FALSE,3062584,1780,350,1430,1065
jocos,FALSE,3061284,1766,523,1243,1144.5
fuzee,FALSE,3060081,1755,1075,680,1415
nanas,FALSE,3059349,2077,679,1398,1378
hamba,FALSE,3059036,1853,522,1331,1187.5
spaza,FALSE,3058471,1908,818,1090,1363
japan,FALSE,3058090,1832,675,1157,1253.5
lolly,FALSE,3055629,1738,1005,733,1371.5
sills,FALSE,3054991,1913,878,1035,1395.5
sowfs,FALSE,3051864,1692,742,950,1217
imshi,FALSE,3051270,1942,191,1751,1066.5
sukhs,FALSE,3050844,1656,628,1028,1142
queme,FALSE,3049282.5,1840,878,962,1359
funny,TRUE,3049044.5,1631,1007,624,1319
arrah,FALSE,3048094,2125,873,1252,1499
gyppo,FALSE,3045506,1736,304,1432,1020
poovy,FALSE,3044990,1585,1075,510,1330
fezes,FALSE,3044718,1916,743,1173,1329.5
zulus,FALSE,3044523,1758,419,1339,1088.5
dixit,FALSE,3043933,1721,736,985,1228.5
skiff,TRUE,3043464,1674,703,971,1188.5
semes,FALSE,3043121,1972,1023,949,1497.5
disks,FALSE,3039187,1837,484,1353,1160.5
exude,FALSE,3038113,1920,744,1176,1332
hexed,FALSE,3038050,1842,759,1083,1300.5
saags,FALSE,3037472,1827,1089,738,1458
shish,FALSE,3037244.5,1644,1086,558,1365
stots,FALSE,3034810,1958,862,1096,1410
kexes,FALSE,3033694,1913,628,1285,1270.5
ferer,FALSE,3032986,2100,1071,1029,1585.5
nalla,FALSE,3032713,2107,679,1428,1393
gesse,FALSE,3031553.5,1974,1032,942,1503
noons,FALSE,3030815.5,1841,778,1063,1309.5
oomph,FALSE,3029792,1696,570,1126,1133
choko,FALSE,3029232,1702,699,1003,1200.5
combo,FALSE,3028893,1686,620,1066,1153
dowdy,TRUE,3025985,1654,849,805,1251.5
potoo,FALSE,3025764,1686,722,964,1204
gobby,FALSE,3025679,1657,839,818,1248
leeze,FALSE,3025555.5,1739,951,788,1345
jagas,FALSE,3024571,1854,590,1264,1222
wexes,FALSE,3023915,1905,691,1214,1298
memes,FALSE,3023497,1972,764,1208,1368
biggy,FALSE,3021879.5,1631,882,749,1256.5
annal,FALSE,3021823,2107,686,1421,1396.5
jefes,FALSE,3021464,1908,641,1267,1274.5
mobby,FALSE,3021407,1655,831,824,1243
belle,TRUE,3019284,1971,1113,858,1542
shahs,FALSE,3018558,1906,881,1025,1393.5
filmi,FALSE,3017092,1800,529,1271,1164.5
huffs,FALSE,3016332,1661,351,1310,1006
kvass,FALSE,3015479.5,1878,549,1329,1213.5
dufus,FALSE,3013684,1652,440,1212,1046
fussy,TRUE,3013105.5,1699,937,762,1318
papal,TRUE,3013023,1903,823,1080,1363
boofy,FALSE,3012730,1564,1095,469,1329.5
emmer,FALSE,3010086.5,2191,701,1490,1446
duffs,FALSE,3009597,1652,393,1259,1022.5
koffs,FALSE,3007144,1700,395,1305,1047.5
booky,FALSE,3005265,1559,1115,444,1337
benne,FALSE,3004795.5,1873,1160,713,1516.5
divvy,FALSE,3002133,1583,772,811,1177.5
seeds,FALSE,3000156.5,2044,890,1154,1467
lulls,FALSE,2999089,1723,584,1139,1153.5
matza,FALSE,2998266,1909,606,1303,1257.5
nakfa,FALSE,2996944,1868,452,1416,1160
kudus,FALSE,2996620,1647,399,1248,1023
lotto,FALSE,2995018,1988,675,1313,1331.5
jolly,TRUE,2994917,1765,937,828,1351
zaman,FALSE,2993615,1792,661,1131,1226.5
guava,TRUE,2991493,1815,718,1097,1266.5
mneme,FALSE,2990761,1904,863,1041,1383.5
vodou,FALSE,2989931,1649,530,1119,1089.5
wussy,FALSE,2987780.5,1686,884,802,1285
zamia,FALSE,2987608,1889,590,1299,1239.5
fogou,FALSE,2986987,1637,615,1022,1126
wudus,FALSE,2986841,1639,462,1177,1050.5
egger,FALSE,2986284.5,2193,681,1512,1437
zakat,FALSE,2985806,1813,735,1078,1274
teeth,TRUE,2985681.5,2102,846,1256,1474
peppy,FALSE,2984484,1819,856,963,1337.5
gazoo,FALSE,2983418,1917,620,1297,1268.5
bundu,FALSE,2980514,1644,568,1076,1106
titis,FALSE,2979434,1932,656,1276,1294
jotty,FALSE,2978382,1784,913,871,1348.5
faffs,FALSE,2976660,1734,536,1198,1135
bezzy,FALSE,2976132,1775,810,965,1292.5
wisps,FALSE,2972638,1805,451,1354,1128
nimbi,FALSE,2972028,1762,335,1427,1048.5
puffs,FALSE,2971440,1628,424,1204,1026
linin,FALSE,2970982.5,1845,717,1128,1281
cubby,FALSE,2970340,1589,829,760,1209
nonny,FALSE,2970146,1640,1001,639,1320.5
kawau,FALSE,2968716,1762,514,1248,1138
flyby,FALSE,2967957,1539,754,785,1146.5
glogg,FALSE,2964713,1621,677,944,1149
pukus,FALSE,2963727,1623,458,1165,1040.5
puddy,FALSE,2963271,1590,836,754,1213
zooms,FALSE,2962818,1624,630,994,1127
xylol,FALSE,2961562,1775,423,1352,1099
yucky,FALSE,2961412,1524,667,857,1095.5
adrad,FALSE,2960339,2116,605,1511,1360.5
kokum,FALSE,2959807,1630,435,1195,1032.5
baiza,FALSE,2959451,1858,827,1031,1342.5
scuzz,FALSE,2958684,1558,595,963,1076.5
mosks,FALSE,2958197,1791,557,1234,1174
smees,FALSE,2956221.5,1972,935,1037,1453.5
seeps,FALSE,2955811.5,2020,871,1149,1445.5
kiddy,FALSE,2953069,1636,730,906,1183
daddy,TRUE,2952187.5,1696,923,773,1309.5
refer,TRUE,2952016,2100,902,1198,1501
slyly,TRUE,2951459.5,1683,1122,561,1402.5
dojos,FALSE,2951247,1688,561,1127,1124.5
foggy,TRUE,2950719.5,1597,922,675,1259.5
jeffs,FALSE,2950094,1908,358,1550,1133
bizzo,FALSE,2948704,1622,464,1158,1043
hoosh,FALSE,2944667,1670,902,768,1286
huggy,FALSE,2944361.5,1553,762,791,1157.5
undug,FALSE,2944055,1677,318,1359,997.5
widdy,FALSE,2943290,1628,793,835,1210.5
xebec,FALSE,2941359,1808,648,1160,1228
chuck,TRUE,2941178,1486,772,714,1129
jumby,FALSE,2940357,1466,655,811,1060.5
jibba,FALSE,2937290,1850,367,1483,1108.5
duppy,FALSE,2937136,1590,769,821,1179.5
zebec,FALSE,2936969,1806,651,1155,1228.5
deeds,FALSE,2935174.5,2044,635,1409,1339.5
annas,FALSE,2934553,2077,566,1511,1321.5
ceded,FALSE,2934238.5,1874,951,923,1412.5
dadas,FALSE,2934128,1897,689,1208,1293
lemel,FALSE,2933981,2002,865,1137,1433.5
vexes,FALSE,2930520,1860,651,1209,1255.5
gamba,FALSE,2929677,1774,568,1206,1171
yeses,FALSE,2929667,2091,682,1409,1386.5
calla,FALSE,2928898,2005,840,1165,1422.5
ragga,FALSE,2928634.5,2046,616,1430,1331
vutty,FALSE,2928278,1690,843,847,1266.5
halal,FALSE,2928250,1936,804,1132,1370
wikis,FALSE,2926481,1661,491,1170,1076
skugs,FALSE,2926210,1577,653,924,1115
papas,FALSE,2925753,1873,703,1170,1288
omovs,FALSE,2925222,1738,405,1333,1071.5
ninny,TRUE,2924240,1614,924,690,1269
peeps,FALSE,2924210.5,2020,647,1373,1333.5
bluff,TRUE,2923625,1579,600,979,1089.5
bajan,FALSE,2923122,1753,773,980,1263
whoop,TRUE,2923102,1592,659,933,1125.5
kiwis,FALSE,2922996,1661,442,1219,1051.5
falaj,FALSE,2920882,1791,715,1076,1253
bazoo,FALSE,2920721,1884,678,1206,1281
pappy,FALSE,2919966,1672,918,754,1295
dummy,TRUE,2919395.5,1542,790,752,1166
eeven,FALSE,2918100,1755,811,944,1283
canna,FALSE,2914409.5,1907,887,1020,1397
apoop,FALSE,2913107.5,1928,634,1294,1281
parra,FALSE,2911283,2092,825,1267,1458.5
shojo,FALSE,2911209,1697,814,883,1255.5
mahwa,FALSE,2910007,1780,509,1271,1144.5
cusks,FALSE,2907130,1725,555,1170,1140
jasps,FALSE,2906755,1900,490,1410,1195
wushu,FALSE,2905183,1648,378,1270,1013
figgy,FALSE,2904813.5,1571,845,726,1208
abuzz,FALSE,2902144,1668,346,1322,1007
chizz,FALSE,2901726,1509,632,877,1070.5
tooth,TRUE,2901116,1719,950,769,1334.5
bosks,FALSE,2899772,1760,623,1137,1191.5
puggy,FALSE,2899469.5,1520,835,685,1177.5
voddy,FALSE,2895801,1609,830,779,1219.5
buffo,FALSE,2895314,1604,477,1127,1040.5
malam,FALSE,2895082.5,1855,728,1127,1291.5
miffy,FALSE,2893335,1569,733,836,1151
deeve,FALSE,2891830.5,1575,1000,575,1287.5
fugus,FALSE,2890502,1582,507,1075,1044.5
guffs,FALSE,2886973,1582,397,1185,989.5
azygy,FALSE,2886966,1661,612,1049,1136.5
affix,TRUE,2886420,1800,340,1460,1070
neeze,FALSE,2885790.5,1641,900,741,1270.5
muffs,FALSE,2882701,1580,389,1191,984.5
babas,FALSE,2879704,1794,733,1061,1263.5
wiggy,FALSE,2879488.5,1558,792,766,1175
lahal,FALSE,2879434,1936,720,1216,1328
seems,FALSE,2876443.5,1972,889,1083,1430.5
muddy,TRUE,2874532,1542,801,741,1171.5
sulus,FALSE,2873583,1723,782,941,1252.5
djinn,FALSE,2873058,1594,691,903,1142.5
sagas,FALSE,2871611,1827,936,891,1381.5
soops,FALSE,2871246,1637,975,662,1306
woofy,FALSE,2870339,1491,1005,486,1248
wootz,FALSE,2869737,1569,749,820,1159
zippo,FALSE,2868185,1701,371,1330,1036
cocos,FALSE,2867769,1739,701,1038,1220
samas,FALSE,2867023,1825,930,895,1377.5
mammy,TRUE,2861805,1624,904,720,1264
inion,FALSE,2860222.5,1870,649,1221,1259.5
jemmy,FALSE,2859892.5,1798,755,1043,1276.5
fezzy,FALSE,2859066,1715,773,942,1244
viffs,FALSE,2858064,1621,341,1280,981
alula,FALSE,2854043.5,2014,733,1281,1373.5
bisks,FALSE,2853866,1734,546,1188,1140
peeve,FALSE,2853673.5,1551,1031,520,1291
fesse,FALSE,2851790.5,1881,1053,828,1467
ganja,FALSE,2851211,1786,624,1162,1205
tweet,TRUE,2847475.5,1917,941,976,1429
mamas,FALSE,2847399,1825,671,1154,1248
casas,FALSE,2845553,1975,781,1194,1378
jafas,FALSE,2845366,1761,548,1213,1154.5
emmet,FALSE,2844458.5,2021,742,1279,1381.5
allay,TRUE,2844255.5,1974,981,993,1477.5
zebub,FALSE,2844070,1815,395,1420,1105
chuff,FALSE,2843984,1491,568,923,1029.5
esnes,FALSE,2842747,2224,581,1643,1402.5
mozos,FALSE,2842567,1624,565,1059,1094.5
cezve,FALSE,2842407,1688,921,767,1304.5
ouzos,FALSE,2841164,1783,406,1377,1094.5
buffi,FALSE,2840770,1578,430,1148,1004
poops,FALSE,2839645,1637,751,886,1194
hubby,FALSE,2839558,1520,700,820,1110
doozy,FALSE,2835775,1495,1018,477,1256.5
biffy,FALSE,2834910,1538,799,739,1168.5
humph,TRUE,2834075,1480,505,975,992.5
zappy,FALSE,2831095,1707,779,928,1243
rurus,FALSE,2827696,1912,572,1340,1242
known,TRUE,2827665.5,1619,506,1113,1062.5
issei,FALSE,2827655,2321,459,1862,1390
assai,FALSE,2827318,2174,411,1763,1292.5
ended,FALSE,2826198.5,1976,670,1306,1323
mojos,FALSE,2824351,1616,557,1059,1086.5
buffs,FALSE,2824276,1549,455,1094,1002
marra,FALSE,2822544,2044,790,1254,1417
kaiak,FALSE,2821012.5,1758,866,892,1312
justs,FALSE,2820827,1769,461,1308,1115
ungum,FALSE,2819090,1605,311,1294,958
jomos,FALSE,2818439,1616,528,1088,1072
bivvy,FALSE,2816812,1480,834,646,1157
buddy,TRUE,2816107,1511,867,644,1189
baboo,FALSE,2814739,1849,724,1125,1286.5
guppy,TRUE,2814512,1520,773,747,1146.5
buchu,FALSE,2814156,1551,444,1107,997.5
jaggy,FALSE,2813605.5,1653,831,822,1242
ewked,FALSE,2812355,1822,564,1258,1193
pozzy,FALSE,2811796,1471,816,655,1143.5
muggy,FALSE,2810730.5,1472,800,672,1136
hapax,FALSE,2810476,1671,602,1069,1136.5
hahas,FALSE,2809640,1906,581,1325,1243.5
axman,FALSE,2808106,1794,509,1285,1151.5
swizz,FALSE,2807278,1494,700,794,1097
bibbs,FALSE,2806352,1532,492,1040,1012
dizzy,TRUE,2804047,1469,708,761,1088.5
cooch,FALSE,2803047,1500,1012,488,1256
tutty,FALSE,2800944,1541,949,592,1245
bubba,FALSE,2799214,1633,504,1129,1068.5
googs,FALSE,2799197.5,1591,750,841,1170.5
swiss,FALSE,2798800.5,1459,883,576,1171
gummy,TRUE,2796771.5,1472,794,678,1133
jammy,FALSE,2795374.5,1651,817,834,1234
pipit,FALSE,2794157,1660,813,847,1236.5
sooms,FALSE,2791878,1589,993,596,1291
tappa,FALSE,2790596,1922,625,1297,1273.5
zuppa,FALSE,2790009,1747,361,1386,1054
hatha,FALSE,2788649,1955,576,1379,1265.5
kazoo,FALSE,2788109,1819,525,1294,1172
bozos,FALSE,2784142,1593,631,962,1112
innit,FALSE,2784018,1864,671,1193,1267.5
vizir,FALSE,2783932,1668,626,1042,1147
ebbet,FALSE,2783893,1990,716,1274,1353
shoos,FALSE,2783555,1670,922,748,1296
zooks,FALSE,2781023,1528,617,911,1072.5
uhuru,FALSE,2780842,1673,495,1178,1084
zobos,FALSE,2779682,1593,507,1086,1050
jembe,FALSE,2779042,1648,771,877,1209.5
abaca,FALSE,2778385,1624,680,944,1152
wazoo,FALSE,2778330,1811,588,1223,1199.5
husks,FALSE,2776348,1656,426,1230,1041
jawan,FALSE,2775954,1680,643,1037,1161.5
vuggs,FALSE,2775459.5,1524,408,1116,966
jomon,FALSE,2774091,1548,622,926,1085
skees,FALSE,2774021.5,1876,907,969,1391.5
sunns,FALSE,2770928.5,1625,909,716,1267
dusks,FALSE,2769613,1647,468,1179,1057.5
gombo,FALSE,2768752,1538,537,1001,1037.5
bobol,FALSE,2765430,1588,797,791,1192.5
cirri,FALSE,2765352,1932,726,1206,1329
barra,FALSE,2764119,2013,856,1157,1434.5
boobs,FALSE,2763446,1558,756,802,1157
swees,FALSE,2763349.5,1868,941,927,1404.5
jooks,FALSE,2763043,1520,634,886,1077
bifid,FALSE,2760360,1491,676,815,1083.5
huffy,FALSE,2757392,1460,679,781,1069.5
meses,FALSE,2757238,1972,783,1189,1377.5
shush,TRUE,2753988.5,1454,985,469,1219.5
palla,FALSE,2753224,1903,784,1119,1343.5
buggy,TRUE,2752305.5,1441,866,575,1153.5
buppy,FALSE,2751815,1487,831,656,1159
twixt,TRUE,2745784,1545,715,830,1130
xysts,FALSE,2744213,1739,278,1461,1008.5
onion,TRUE,2744190.5,1870,656,1214,1263
fixit,FALSE,2741546,1558,761,797,1159.5
pygmy,TRUE,2738409,1361,664,697,1012.5
fisks,FALSE,2736800,1674,509,1165,1091.5
dodos,FALSE,2732584,1661,633,1028,1147
nanua,FALSE,2732392,1916,626,1290,1271
javas,FALSE,2732094,1703,572,1131,1137.5
appal,FALSE,2731474.5,1903,579,1324,1241
chich,FALSE,2727983,1474,899,575,1186.5
tutus,FALSE,2727125,1742,564,1178,1153
phizz,FALSE,2726052,1407,576,831,991.5
zuzim,FALSE,2724008,1437,400,1037,918.5
aflaj,FALSE,2722597,1791,424,1367,1107.5
quaff,FALSE,2722010,1602,577,1025,1089.5
fedex,FALSE,2721249,1670,779,891,1224.5
jokol,FALSE,2719292,1550,599,951,1074.5
faffy,FALSE,2717720,1533,864,669,1198.5
puffy,TRUE,2712500,1427,752,675,1089.5
yappy,FALSE,2709062,1672,782,890,1227
gonzo,FALSE,2708560,1558,611,947,1084.5
algal,FALSE,2707002.5,1857,728,1129,1292.5
doddy,FALSE,2705205.5,1460,898,562,1179
wexed,FALSE,2703603,1657,773,884,1215
hooch,FALSE,2700892,1500,883,617,1191.5
fuddy,FALSE,2699041,1451,830,621,1140.5
beses,FALSE,2698813,1941,849,1092,1395
accas,FALSE,2698419,1975,436,1539,1205.5
yuzus,FALSE,2698375,1527,321,1206,924
seeks,FALSE,2694648.5,1876,876,1000,1376
abaya,FALSE,2689685,1593,531,1062,1062
zexes,FALSE,2683124,1746,611,1135,1178.5
howff,FALSE,2679166,1453,435,1018,944
bobos,FALSE,2678160,1558,677,881,1117.5
wawas,FALSE,2677456.5,1721,612,1109,1166.5
mizzy,FALSE,2677151,1397,704,693,1050.5
deedy,FALSE,2676234.5,1843,963,880,1403
jewed,FALSE,2676088,1647,724,923,1185.5
llama,TRUE,2675556.5,1855,728,1127,1291.5
jibbs,FALSE,2674854,1559,339,1220,949
wuddy,FALSE,2673716,1438,777,661,1107.5
ottos,FALSE,2673254,1958,397,1561,1177.5
poppy,TRUE,2672984,1436,893,543,1164.5
weeke,FALSE,2671557.5,1452,981,471,1216.5
whoof,FALSE,2666650,1453,629,824,1041
gogos,FALSE,2663501,1591,629,962,1110
jutty,FALSE,2662902,1568,820,748,1194
whiff,TRUE,2662011,1427,554,873,990.5
morro,FALSE,2661619,1808,759,1049,1283.5
pipis,FALSE,2659897,1611,596,1015,1103.5
diddy,FALSE,2659299.5,1434,821,613,1127.5
amass,TRUE,2655420.5,1825,693,1132,1259
keeks,FALSE,2655157,1876,530,1346,1203
nunny,FALSE,2654666,1424,908,516,1166
skyfs,FALSE,2652494,1444,476,968,960
heeze,FALSE,2651193.5,1470,932,538,1201
boozy,TRUE,2650454,1392,1080,312,1236
manna,FALSE,2649996.5,1757,796,961,1276.5
level,TRUE,2646092,1853,853,1000,1353
musks,FALSE,2642717,1575,464,1111,1019.5
lulus,FALSE,2640499,1723,504,1219,1113.5
hollo,FALSE,2637191,1700,680,1020,1190
fuggy,FALSE,2635239.5,1381,829,552,1105
dadah,FALSE,2631534,1658,792,866,1225
pippy,FALSE,2627078,1410,816,594,1113
kaika,FALSE,2620648.5,1758,709,1049,1233.5
bizzy,FALSE,2618726,1366,770,596,1068
mommy,FALSE,2614823,1388,879,509,1133.5
massa,FALSE,2614057.5,1825,726,1099,1275.5
urubu,FALSE,2613976,1561,490,1071,1025.5
iodid,FALSE,2612200.5,1690,664,1026,1177
ziffs,FALSE,2610668,1507,301,1206,904
vexed,FALSE,2610208,1612,733,879,1172.5
sooks,FALSE,2610083,1493,980,513,1236.5
filii,FALSE,2609420,1502,619,883,1060.5
yacca,FALSE,2608983,1774,582,1192,1178
yabby,FALSE,2604749,1593,755,838,1174
nappa,FALSE,2603929,1805,513,1292,1159
simis,FALSE,2601167,1563,823,740,1193
kakas,FALSE,2595685,1729,535,1194,1132
bobby,TRUE,2593318,1357,897,460,1127
jiffs,FALSE,2592688,1499,318,1181,908.5
quipu,FALSE,2592186,1479,526,953,1002.5
attap,FALSE,2591805,1922,548,1374,1235
doody,FALSE,2591669,1460,1067,393,1263.5
batta,FALSE,2589525,1843,791,1052,1317
hamza,FALSE,2586488,1621,518,1103,1069.5
namma,FALSE,2586188.5,1757,534,1223,1145.5
ajwan,FALSE,2585643,1680,462,1218,1071
busks,FALSE,2584292,1544,530,1014,1037
kaama,FALSE,2583538,1409,763,646,1086
audad,FALSE,2581515.5,1736,683,1053,1209.5
masas,FALSE,2581140,1825,690,1135,1257.5
poopy,FALSE,2580705,1436,1079,357,1257.5
potto,FALSE,2575764,1686,729,957,1207.5
zezes,FALSE,2574862,1709,610,1099,1159.5
keeve,FALSE,2573897.5,1407,909,498,1158
lusus,FALSE,2570968,1723,472,1251,1097.5
agama,FALSE,2570807,1507,592,915,1049.5
kooks,FALSE,2570591.5,1493,634,859,1063.5
buffy,FALSE,2565336,1348,783,565,1065.5
mumms,FALSE,2558283,1373,458,915,915.5
assay,TRUE,2551884,1944,764,1180,1354
choco,FALSE,2547830,1500,796,704,1148
huzzy,FALSE,2541208,1288,650,638,969
zippy,FALSE,2538207,1445,677,768,1061
jisms,FALSE,2534499,1590,406,1184,998
amman,FALSE,2532686.5,1757,533,1224,1145
fubby,FALSE,2530436,1348,767,581,1057.5
ajuga,FALSE,2526146,1693,448,1245,1070.5
sibbs,FALSE,2521894,1532,685,847,1108.5
jiggy,FALSE,2520717.5,1391,729,662,1060
deked,FALSE,2519062.5,1628,801,827,1214.5
minim,TRUE,2516857.5,1495,648,847,1071.5
vuggy,FALSE,2516519.5,1323,736,587,1029.5
abbas,FALSE,2516469,1794,413,1381,1103.5
ajiva,FALSE,2515350,1732,519,1213,1125.5
fluff,TRUE,2513547,1312,563,749,937.5
sexes,FALSE,2512184,1711,974,737,1342.5
ngana,FALSE,2511289.5,1759,602,1157,1180.5
woozy,TRUE,2508063,1319,990,329,1154.5
dewed,FALSE,2505798.5,1620,815,805,1217.5
bucku,FALSE,2505495,1374,471,903,922.5
booby,TRUE,2504506,1357,1084,273,1220.5
lolog,FALSE,2502541,1621,652,969,1136.5
jimmy,FALSE,2502486.5,1389,715,674,1052
fizzy,TRUE,2501660,1306,733,573,1019.5
madam,TRUE,2496609.5,1577,691,886,1134
motto,TRUE,2487025,1638,694,944,1166
ovolo,FALSE,2484086,1470,520,950,995
fifis,FALSE,2478766,1472,557,915,1014.5
taata,FALSE,2473860,1576,963,613,1269.5
ictic,FALSE,2472495.5,1762,374,1388,1068
laval,FALSE,2469994,1706,760,946,1233
dilli,FALSE,2469776,1665,598,1067,1131.5
jesse,FALSE,2467694.5,1701,937,764,1319
fusks,FALSE,2467226,1484,493,991,988.5
walla,FALSE,2463669,1751,725,1026,1238
femme,TRUE,2455693.5,1561,931,630,1246
mosso,FALSE,2453132.5,1589,695,894,1142
wanna,FALSE,2449180.5,1653,772,881,1212.5
kayak,TRUE,2443188.5,1528,629,899,1078.5
quiff,FALSE,2439684,1340,536,804,938
whizz,FALSE,2436497,1255,517,738,886
immit,FALSE,2426499.5,1612,544,1068,1078
sudds,FALSE,2420925,1445,732,713,1088.5
yippy,FALSE,2416174,1410,680,730,1045
fuffs,FALSE,2414198,1282,418,864,850
jazzy,TRUE,2410452,1388,719,669,1053.5
pupus,FALSE,2407588,1421,504,917,962.5
muzzy,FALSE,2407577,1207,688,519,947.5
zhomo,FALSE,2405007,1385,517,868,951
akkas,FALSE,2393179,1729,362,1367,1045.5
duddy,FALSE,2389725.5,1244,805,439,1024.5
peepe,FALSE,2389388.5,1402,1035,367,1218.5
tazza,FALSE,2387933,1611,548,1063,1079.5
appay,FALSE,2385264.5,1672,787,885,1229.5
bacca,FALSE,2378129,1624,749,875,1186.5
edged,FALSE,2366666,1726,595,1131,1160.5
egged,FALSE,2366084.5,1726,587,1139,1156.5
phpht,FALSE,2364203,1392,625,767,1008.5
dagga,FALSE,2363087.5,1579,622,957,1100.5
bubus,FALSE,2361539,1342,534,808,938
mimic,TRUE,2361188,1393,559,834,976
yobby,FALSE,2357767,1357,730,627,1043.5
puppy,TRUE,2357504,1220,800,420,1010
oppos,FALSE,2353469.5,1637,328,1309,982.5
assam,FALSE,2352944,1825,442,1383,1133.5
buzzy,FALSE,2349152,1176,754,422,965
feeze,FALSE,2342071.5,1298,999,299,1148.5
kuzus,FALSE,2334909,1312,335,977,823.5
infix,FALSE,2334285,1441,312,1129,876.5
butut,FALSE,2333761,1391,805,586,1098
jiffy,TRUE,2333748,1298,646,652,972
abaka,FALSE,2331888,1378,583,795,980.5
jocko,FALSE,2330001,1350,468,882,909
ebbed,FALSE,2329321,1693,581,1112,1137
mumus,FALSE,2329234,1373,472,901,922.5
pampa,FALSE,2324683,1553,621,932,1087
commo,FALSE,2321448.5,1419,664,755,1041.5
jukus,FALSE,2315401,1304,336,968,820
kooky,FALSE,2311651.5,1292,962,330,1127
kirri,FALSE,2309902,1686,548,1138,1117
gynny,FALSE,2309887.5,1267,823,444,1045
zanja,FALSE,2305332,1521,512,1009,1016.5
yabba,FALSE,2303817,1593,455,1138,1024
mummy,TRUE,2299343,1172,786,386,979
huhus,FALSE,2291475,1454,382,1072,918
queue,TRUE,2287745.5,1542,892,650,1217
exeme,FALSE,2284118.5,1391,755,636,1073
bubby,FALSE,2277838,1141,804,337,972.5
kinin,FALSE,2271952.5,1399,649,750,1024
papaw,FALSE,2270538,1449,684,765,1066.5
magma,TRUE,2268939.5,1507,610,897,1058.5
zizit,FALSE,2267168,1349,627,722,988
dabba,FALSE,2258284,1546,560,986,1053
sukuk,FALSE,2253471.5,1277,759,518,1018
mezze,FALSE,2246262,1389,804,585,1096.5
kikoi,FALSE,2243745,1522,377,1145,949.5
pzazz,FALSE,2243140,1290,475,815,882.5
pawaw,FALSE,2241803.5,1449,652,797,1050.5
fuzzy,TRUE,2232086,1116,717,399,916.5
zanza,FALSE,2230126,1494,530,964,1012
effed,FALSE,2224277,1633,541,1092,1087
yakka,FALSE,2224226.5,1528,441,1087,984.5
gamma,TRUE,2222232.5,1507,612,895,1059.5
doggo,FALSE,2202162.5,1343,591,752,967
mamba,FALSE,2193234,1474,560,914,1017
exeem,FALSE,2179219.5,1391,623,768,1007
cippi,FALSE,2178509,1441,519,922,980
anana,FALSE,2176169.5,1459,781,678,1120
fuffy,FALSE,2155258,1081,746,335,913.5
yuppy,FALSE,2146600,1220,664,556,942
yobbo,FALSE,2142892,1357,424,933,890.5
pakka,FALSE,2140536.5,1457,577,880,1017
gabba,FALSE,2135660,1476,564,912,1020
yummy,FALSE,2128859.5,1172,685,487,928.5
zorro,FALSE,2120012,1545,655,890,1100
hudud,FALSE,2109193.5,1206,530,676,868
babka,FALSE,2107802,1378,653,725,1015.5
bombo,FALSE,2087559,1238,595,643,916.5
nanna,FALSE,2080127,1459,726,733,1092.5
kukus,FALSE,2077520,1277,336,941,806.5
bussu,FALSE,2069039.5,1342,611,731,976.5
zimbi,FALSE,2062193,1247,301,946,774
kabab,FALSE,2061138,1378,555,823,966.5
emmew,FALSE,2054983.5,1548,506,1042,1027
villi,FALSE,2048669,1444,530,914,987
jugum,FALSE,2048526,1082,397,685,739.5
kappa,TRUE,2044664,1457,496,961,976.5
wagga,FALSE,2035375.5,1403,594,809,998.5
jnana,FALSE,2030674.5,1486,660,826,1073
civic,TRUE,2029030.5,1244,638,606,941
vivid,TRUE,2026837,1166,570,596,868
tuktu,FALSE,2015738,1326,487,839,906.5
hyphy,FALSE,1981314,1142,542,600,842
gobbo,FALSE,1974735,1240,533,707,886.5
yukky,FALSE,1962696.5,1076,623,453,849.5
jeeze,FALSE,1957975.5,1118,883,235,1000.5
esses,FALSE,1925788,1674,522,1152,1098
kudzu,FALSE,1901479,1064,302,762,683
gyppy,FALSE,1895592,1063,610,453,836.5
cocco,FALSE,1888459,1121,743,378,932
jujus,FALSE,1881791,1102,327,775,714.5
oxbow,FALSE,1849767,1171,261,910,716
susus,FALSE,1844255,1075,750,325,912.5
boffo,FALSE,1829872,1147,570,577,858.5
ayaya,FALSE,1776856,1326,538,788,932
jinni,FALSE,1768804.5,1224,554,670,889
zocco,FALSE,1734022,1156,548,608,852
mamma,TRUE,1724804,1207,604,603,905.5
addax,FALSE,1648480.5,1316,407,909,861.5
kibbi,FALSE,1618746,1116,314,802,715
zoppo,FALSE,1533169,1054,448,606,751
jaffa,FALSE,1489635,1143,448,695,795.5
xylyl,FALSE,1415267,1102,294,808,698
qajaq,FALSE,1394268,965,493,472,729
immix,FALSE,1307059.5,982,299,683,640.5
